@rowCount	2000
w	d	t
korikeem	people	SU
korobutik	dignitary	SU
kosabé	determine	VT
kosayik	cousin	SU
kosayikya	cousin	SU
kosik	victim	AQ
kosmá	examine	VT
kosmara	discovery	SU
kost	compendium	SU
kostá	insert	VT
kostara	introduction	SU
kosuté	enter	VT
kosutera	entry	SU
koswá	imply	VT
kotabaf	eternal	AQ
kotaf	entire	AQ
kotaksataf	monthly	AQ
kotaskira	accomplishment	SU
kotawara	burial	SU
kotca	claw	SU
kotcá	scratch	VT
kotcoba	all	PN
kotcomera	sly joke	SU
koteyá	kindle	VT
kotgrupé	celebrate	VT
kotinde	for every reason	AV
kotla	university	SU
kotliz	everywhere	AV
kototawé	get in	VI
kotrakura	education	SU
kotrakus	instructive	PA
kotron	completely	AV
koverté	record	VT
kovertokara	admission	SU
kovoa	affluent	SU
kovogá	swear	VT
koyá	travel	VI
koyara	journey	SU
koyaralafaga	tourist agency	SU
koyasik	traveller	SU
koyutarula	tourism	SU
koyva	asphalt	SU
koyvá	asphalt	VT
kozwí	descry	VT
kraba	apartment	SU
krafol	wheel	SU
krafolm	roll	SU
kraimol	leopard	SU
krajú	condescend	VT
kralka	scale	SU
kramon	genuinely	AV
kramta	orange	SU
kramtaal	orange-tree	SU
kramtukaf	orange-coloured	AQ
krapol	lion	SU
krapoloc	whelp	SU
krapolya	lioness	SU
krasey	southernwood	SU
krayta	tide	SU
kreda	condition	SU
krede	da if	CJ
krem	absinth	SU
krent	words	SU
krenugaf	affectionate	AQ
krenugon	softly	AV
krepka	cell	SU
krets	blot	SU
kretú	charge	VT
krey	satellite	SU
kreyta	anvil	SU
krezé	faint	VI
krido	pike	SU
kriel	krypton	SU
kriga	shoulder	SU
krimba	rib	SU
krimbaxa	cutlet	SU
krimt	coast	SU
kru	glue	SU
krú	glue	VT
kruba	olive	SU
krubaal	olive-tree	SU
kruldé	exist	VI
krumká	hiccup	VI
krungaf	acid	AQ
krunguca	unkindness	SU
krus	adhesive	PA
krusuca	adhesion	SU
ksago	pineapple	SU
ksagokratela	pineapple juice	SU
ksé	commit suicide	VI
kseara	assembly	SU
kseldú	recruit	VT
ksent	ear	SU
ksevá	colour	VT
ksewa	osier	SU
ksodakola	angina	SU
ksubé	apply	VT
ksudá	copy	VT
ku	crane	SU
kubelik	proletarian	AQ
kuca	grace	SU
kuce	thisle	SU
kucilá	need	VT
kucilara	approach	SU
kuda	fable	SU
kudel	chlorine	SU
kudja	statue	SU
kueca	seal	SU
kufta	axe	SU
kuja	ferry	SU
kuk	ticket-window	SU
kuksa	river	SU
kuksama	brook	SU
kulaf	rich	AQ
kuld	shell	SU
kulirna	chopper	SU
kulmé	mean	VT
kulor	trunk	SU
kulton	awfully	AV
kuluca	wealth	SU
kulupaf	resplendant	AQ
kuré	be married	VT
kurenaf	married	AQ
kurenikya	wife	SU
kurenikye	husband	AQ
kurera	marriage	SU
kuritca	clay	SU
kuriudanaf	able	AQ
kurná	spice	VT
kurt	tongs	SU
kurtá	pinch	VT
kusaf	green	AQ
kusia	aster	SU
kustrol	giraffe	SU
kutc	lip	SU
kutcedá	have sex	VT
kwala	viper	SU
kwik	domestic animal	AQ
laba	dune	SU
ladava	elbow	SU
laday	cable	SU
lae	relief	SU
lafaga	agency	SU
lag	job	SU
laga	cube	SU
laizon	all of a sudden	AV
lamá	migrate	VI
lamas	itinerant	PA
lambey	capercaillie	SU
lamé	wear down	VT
lamone	castle	SU
lanaf	reliable	AQ
landesiki	plane	SU
lanhá	condemn	VT
lanhey	intestine	SU
laof	daring	AQ
laona	hallucination	SU
laoon	boldly	AV
lapí	go	VI
larida	throat	SU
laspedaf	brave	AQ
laspeduca	courage	SU
latime	mortgage	SU
latista	dragonfly	SU
latkaf	blond	AQ
laumá	increase	VI
lavafozdema	towel	SU
lavaga	hydrogen	SU
lavagul	hydrate	SU
lavajeb	brandy	SU
lavak	aquarium	SU
lavakiraf	watery	AQ
lavanarilt	aqueduct	SU
lavasevero	sea-plane	SU
lavatral	hydraulics	SU
lavatralaf	hydroelectric	AQ
lavolk	drop	SU
layta	tissue	SU
lazava	cause	SU
leakom	shovel	SU
leakomá	shovel	VT
lebaf	bare	AQ
leca	symbol	SU
lefini	pyjamas	SU
legaf	tired	AQ
legas	passive	PA
legeja	sole	SU
lejá	pump	VT
lejasiko	pump	SU
lekeon	long ago	AV
lele(d)-	less and less	PT
lelt	leather	SU
lembié	boil	VT
lembieda	bouillon	SU
lent	across from	SU
lenteka	north	SU
lentor	fa#ade	SU
lerd-saneaf	ninetieth	AQ
lerd-sanoy	ninety	AN
lerdeaksat	September	SU
levayká	guess	VT
levaykas	would-be	PA
levaykason	da supposing that	GE
levbiraf	submarine	AQ
levbiratota	submarine	SU
levburé	abide	VT
levcenhé	convince	VT
levconhá	remark	VT
levetawaf	underground	AQ
levetirik	slave	AQ
levetiruca	serfdom	SU
levgá	pass	VT
levgaf	sudden	AQ
levgira	behalf	SU
levion	lately	AV
levkipé	smile	VI
levlavá	immerse	VT
levlavaf	underwater	AQ
levoksé	subtract	VT
levoksera	subtraction	SU
levplekú	submit	VT
levsugdalaks	overtone	SU
levtiruca	slavery	SU
lewa	slug	SU
lexa	music	SU
lexusik	musician	SU
lhaf	axial	AQ
lhava	drive shaft	SU
lhumá	struggle	VT
lhumara	struggle	SU
liba	pus	SU
libakol	hare	SU
libol	rabbit	SU
libolxo	warren	SU
libú	vote	VT
licá	oppress	VT
licarundá	agglomerate	VT
licarundawé	agglomerate	VI
licedá	agglutinate	VT
licedara	agglutination	SU
licedas	agglutinative	PA
lidaf	moral	AQ
limega	dial	SU
limegama	diskette	SU
linaf	apathetic	AQ
lingé	paint	VT
lingera	dye	SU
lingesik	painter	SU
linté	persevere	VI
liom	customs	SU
liomik	customs officer	SU
lioza	cloak	SU
liozak	cloakroom	SU
lipta	bastion	SU
lird	well	SU
lirdé	draw	VT
lirk	obstacle	SU
listaf	beautiful	AQ
listikya	beauty	SU
listuca	beauty	SU
lit	printed matter	SU
litca	vein	SU
litiel	lithium	SU
liugé	put to sleep	VI
livaf	bent	AQ
liwa	card	SU
liway	cardboard	SU
lize	where	AV
lizimeltasiko	engine	SU
lizira	movement	SU
lizukaf	regional	AQ
lizukedú	farm	VT
lizukeduray	rent	SU
lizukedusik	renter	SU
lizuxo	aerie	SU
loba	marsh	SU
lofra	musket	SU
lofta	seagull	SU
logá	digest	VT
loité	comb	VT
loitesiki	comb	SU
lokaza	belladonna	SU
loma	category	SU
loon	else	AV
lorbaf	pious	AQ
lorbuca	devotion	SU
lordé	plan	VT
lordeks	design	SU
lorik	god	SU
loror	swan	SU
lorot	banquet	SU
lorotá	banquet	VI
lorotaf	worse	AQ
lorspa	ski	SU
lospa	group	SU
lospá	group	VT
lostá	drain	VT
losumeon	beyond	AV
lotasiko	shower	SU
louca	majority	SU
lovaf	positive	AQ
lovolk	command	SU
loy	rubber	SU
loyen	job-	PA
lo(d)-	more	PT
lubé	drop	VI
lubek	toe	SU
ludev	feature	SU
ludot	lock	SU
ludzé	split	VT
luez	tomato	SU
lugavaf	extreme	AQ
lugodaf	elevated	AQ
lujaf	ablaze	AQ
lujor	square	SU
lujuca	glow	SU
lukast	beard	SU
lukastkiraf	bearded	AQ
lukidoy	balustrade	SU
lukoptaf	grey	AQ
lukraf	adult	AQ
lum	measure	SU
lume	pavement	SU
lumisá	compensate	VT
lumiskuca	infinity	SU
lumislon	endlessly	AV
lund	moped	SU
lundek	streetcar	SU
lurk	paragraph	SU
lurská	brave	VT
lusteks	acquisition	SU
lut	copper	SU
luwí	ad-lib	VT
luxe	as regards	PP
luz	chapter	SU
lwí	attempt	VT
lwira	attempt	SU
ma	upper arm	SU
maaktaca	stunt	SU
maaktaf	acrobatic	AQ
maaktik	acrobat	AQ
madá	lever	VT
madasiki	lever	SU
mafelá	admire	VT
mafelaf	admirable	AQ
mafelara	admiration	SU
mafelas	admiring	PA
mafelasik	admirer	SU
magda	cap	SU
magnel	magnesium	SU
malgildé	hear	VT
malgulyá	moor	VT
malhaf	correct	AQ
malhé	judge	VT
malhera	adjudication	SU
malherot	justice	SU
malhesik	judge	SU
malhon	equitably	AV
mali	since	PP
mallaní	start off	VT
mallanira	departure	SU
mallapí	drive away	VT
malterktá	pay attention to	VT
malti	gravel	SU
maltrakú	abstract	VT
malvajá	download	VT
mam	sound	SU
mamá	sound	VI
mamlé	give a ring	VT
mamlesiki	bell	SU
mamtaf	sonorous	AQ
mantaf	lax	AQ
manton	widely	AV
mantuca	expanse	SU
mard	pearl	SU
marna	key	SU
marná	lock	VT
martig	style	SU
marwida	curtain	SU
masdjida	mosque	SU
matela	garden	SU
matelamidura	gardening	SU
matelik	gardener	SU
mawazanisikya	maid	SU
mayakaf	dismal	AQ
mazdaf	gaunt	AQ
me	no	AV
mea	no longer	AV
meabdiwis	unsuspected	PA
mearapenis	changeless	PA
mebast	hurdle	SU
mecoba	not an ace	PN
mecta	hysteria	SU
mectaf	hysterical	AQ
medolaf	rude	AQ
medotolmilaf	asymmetric	AQ
medra	balm	SU
medrega	pomade	SU
meenide	for no reason	AV
meetrakason	no doubt	AV
mefavlaf	useless	AQ
megol	whale	SU
megrupen	stranger	PA
megrupes	unknown	PA
megunaf	guiltless	AQ
meilkaf	impersonal	AQ
meinde	by no means	AV
mejé	accept	VI
mekalvekaf	poor	AQ
mekeyen	abrupt	PA
mekotunaf	defective	AQ
melanaf	doubtful	AQ
meld	blow	SU
meliz	nowhere	AV
meok	district	SU
merikol	otter	SU
merna	cushion	SU
merodojenias	incompatible	PA
merontif	indirect	AQ
meropatan	countless	PA
meropatavan	inmeasurable	PA
merotis	impossible	PA
merotisaca	impossibility	SU
merotisuca	impossibility	SU
merowin	invisible	PA
meruptes	independent	PA
mestá	commute	VT
mestasiko	switch	SU
metageltaf	incorrect	AQ
metageltuca	inaccuracy	SU
metamaf	discordant	AQ
metan	neither	PN
metegiruca	inactivity	SU
meú	deny	VT
meviele	never	AV
mevtava	mountain	SU
mevtuti	mountaineering	SU
mevtutiusik	alpinist	SU
mewaya	ankle	SU
mewison	blindly	AV
mexeyuca	absurdity	SU
mhelga	hammer	SU
mhetc	temple	SU
mhetca	magnifying-glass	SU
mheza	parquet	SU
mhot	fur	SU
mhoté	push along	VT
miafiz	midday	SU
miafizestura	dine	SU
miala	half	SU
mialaf	half	AQ
mialodaf	impartial	AQ
mialpa	hub	SU
mialuk	average	SU
mialukaf	average	AQ
miazilí	borrow	VT
mical	ant	SU
micalxo	ant-hill	SU
mil	same	AI
milaskí	imitate	VT
mildaf	tender	AQ
milduca	tenderness	SU
milé	stagnate	VI
mileniltik	fellow-thinker	SU
milexavik	colleague	SU
milgaf	dainty	AQ
milgemelton	at the same time	AV
milgik	adult	SU
milk	troop	SU
milka	casserole	SU
milkaf	identical	AQ
milkava	flock	SU
milklaaf	of the same age	AQ
milmura	advertisement	SU
milon	equally	AV
milost	saddle	SU
miltaf	equal	AQ
miltay	equation	SU
milunt	barrel	SU
milvodaf	equivalent	AQ
mimadjo	missile	SU
min	we	PN
minia	belief	SU
minsa	violet	SU
mintila	attic	SU
mirn	satin	SU
mit	crust	SU
mivaskaf	automatic	AQ
mivaskik	automoton	SU
mivexuca	autarchy	SU
mivirubaf	indigenous	AQ
mivokaf	spontaneous	AQ
mivtanizva	autobiography	SU
mivtanizvaf	autobiographical	AQ
miwá	mention	VT
mo	at	PP
moblisik	survivor	SU
mocoé	bilk	VT
modemá	hook	VT
modera	sleep	SU
modivatcesiki	cover	SU
mokina	glycerine	SU
mola	appetite	SU
molikera	affront	SU
molt	harbour	SU
momimá	project	VT
mona	house	SU
monaf	domestic	AQ
monaja	barrack	SU
monaxo	town	SU
monif	close	AQ
mopoyé	break into	VT
moraf	modest	AQ
morbé	bet	VT
moruca	modesty	SU
morumká	postpone	VT
motc	quarrel	SU
motcá	quarrel	VT
motidá	go beyond	VT
mou	bosom	PP
mouak	bra	SU
mouk	breast	SU
moukdunol	mammal	SU
moukot	nipple	SU
mouvo	udder	SU
movera	confession	SU
movura	acknowledgement	SU
moxinaf	baleful	AQ
mu	because of	PP
mubé	select	VT
mucú	contort	VT
muge	adverb	SU
mugef	adverbial	AQ
muka	article	SU
mukodaf	objective	AQ
mukodakiraf	transitive	AQ
mukot	objective	SU
muktu	bucket	SU
mulaf	thoroughgoing	AQ
muson	safely	AV
mustaf	bleak	AQ
mustok	lily-of-the-valley	SU
musuca	safety	SU
mutoza	chive	SU
muva	rain	SU
muvar	rain	VZ
muvuda	jonquil	SU
muvugal	autumn	SU
muvugalaf	autumn	AQ
muxelk	altar	SU
mwa	law	SU
mwedaf	legal	AQ
mweluca	legality	SU
naav	peg	SU
naavá	connect	VT
naavdá	succeed	VT
naavdara	success	SU
nabé	peel	VT
nabinel	sodium	SU
naboxa	grave	SU
naca	kind turn	SU
nael	pole	SU
nafalaf	sovereign	AQ
nafalik	sovereign	AQ
nak	hay	SU
nakera	torture	SU
nakila	scene	SU
nalenaf	accepted	AQ
nalesik	acceptor	SU
namhé	provide	VT
nami	memory	SU
namion	by heart	AV
namulol	sheep	SU
namulolié	bleat	VI
namuloloc	lamb	SU
namulolye	ram	SU
nanda	compass	SU
napleka	whitebeam berry	SU
naplekaal	whitebeam	SU
narí	lay hold of	VT
nasbukaf	fertile	AQ
naskoya	zinnia	SU
nasta	gene	SU
naviulaal	elm	SU
neciaf	dainty	AQ
neda	committee	SU
nedel	aluminium	SU
nedí	show	VT
nedoy	naught	AN
neel	neon	SU
nefadik	clown	SU
nefta	fly	SU
nega	narrative	SU
negá	recite	VT
negova	crocodile	SU
negruya	cucumber	SU
nekev	despite	PP
nelkaf	chief	AQ
nelkon	chiefly	AV
nelkot	principle	SU
nemon	accurately	AV
nendá	guard	VT
nendara	protection	SU
nendas	protectionist	PA
nendasik	patron	SU
nendoyé	guard	VT
nendoyesiki	preservative	SU
nerla	trump	SU
nesá	court	VT
nesida	phase	SU
nesuk	vest	SU
neuzé	stammer	VI
neva	book	SU
nevaxe	bookcase	SU
nevonha	bookshop	SU
nevonhik	bookseller	SU
nevoyol	chamois	SU
nexa	bacterium	SU
nexaf	bacterial	AQ
nexatorik	bacteriophage	SU
nexopa	bacteriology	SU
nexopaf	bacteriological	AQ
nexopik	bacteriologist	SU
nhela	helium	SU
nhelik	champion	AQ
nhobrik	widower	AQ
nhobrikya	widow	SU
nhonda	apron	SU
nhorku	onion	SU
nhoxa	moustache	SU
nhukuca	cowardice	SU
nia	direction	SU
niaaf	ungrateful	AQ
niauca	ingratitude	SU
nida	quicksilver	SU
nik	friend	SU
nikya	friend	SU
nilaf	narrow	AQ
nimat	leg	SU
nimatek	ham	SU
nios	script	SU
nirá	polish	VT
niranaf	courteous	AQ
nisay	abscissa	SU
niska	bone	SU
niskaf	bony	AQ
nitca	quail	SU
nité	consist	VT
niusté	jest	VI
niustera	gag	SU
noaf	intense	AQ
nobá	interact	VT
nobaf	frequent	AQ
noca	rectum	SU
nodek	alfenide	SU
noelaca	topic	SU
noelaceem	news	SU
noelaf	current	AQ
noelkeon	at present	AV
noelon	currently	AV
noeltaf	fresh	AQ
noelton	recently	AV
noeluca	topicality	SU
nogla	nerve	SU
noglotaf	nervous	AQ
nok	band	SU
nolié	jingle	VI
nom	dusk	SU
nomarna	dahlia	SU
nomist	tyre	SU
non	friendly	AV
nopalol	jackal	SU
norisk	mast	SU
norka	brick	SU
norluca	genius	SU
nostá	project	VT
notaf	friendly	AQ
nouli	needle	SU
nové	allow	VT
novera	permission	SU
noyelt	raquet	SU
nuba	hand	SU
nubá	handle	VT
nubacek	grip	SU
nubagí	clutch	VT
nubakobaxo	workshop	SU
nubalicara	handshake	SU
nubaroperopa	surgery	SU
nubask	wrist	SU
nubedaf	manual	AQ
nubedik	manual	AQ
nubelt	sleeve	SU
nubok	fist	SU
nubutiú	box	VI
nuca	friendship	SU
nudama	alley	SU
nudol	duck	SU
nuga	foot	SU
nugapé	trample on	VT
nugaviputi	football	SU
nugavlak	stepladder	SU
nugé	tease	VT
nugervolia	infantry	SU
nugetc	pedal	SU
nujna	brush	SU
nuka	exercise-book	SU
nula	brimstone	SU
nurgey	shank	SU
nustaf	stringent	AQ
nutik	nephew	SU
nutikya	niece	SU
oblay	pole	SU
obleda	barricade	SU
obledá	barricade	VT
obras	alert	PA
obrason	attentively	AV
odiakuca	confidence	SU
oga	abode	SU
ogalt	pencil	SU
ogluk	core	SU
oglukaf	nuclear	AQ
ogolé	refuse	VT
ok	or	CJ
okildirem	ambulance	SU
okilik	boss	SU
okollakí	ride	VI
okolya	mare	SU
oksi	fabric	SU
oksif	text	SU
olaxa	tobacco	SU
olda	lyc#e	SU
olerd	pollen	SU
olgaf	hard	AQ
olgalicú	conquer	VT
olgalicura	invasion	SU
olha	spoke	SU
olhak	radio	SU
olhasté	torment	VT
olhastera	torment	SU
olhavesiko	radiator	SU
olhub	barley	SU
olitc	gun-carriage	SU
olkik	chap	SU
olkotca	bit	SU
olkxo	barn	SU
oltavik	fellow-creature	SU
oluaf	aristocratic	AQ
oluik	aristocrat	SU
oluikeem	aristocracy	SU
oluikya	dame	SU
olutaf	illiterate	AQ
olutik	illiterate	AQ
olvezá	rake	VT
oná	fish	VT
onasik	fisherman	SU
onká	chase	VT
onotca	hail	SU
ont	that is	CJ
ontinaf	noble	AQ
ontinaxaf	proud	AQ
ontinaxon	proudly	AV
ontine	peak	SU
ontinuca	altitude	SU
ontinuk	altitude	SU
ontinuksabesiki	altimeter	SU
opa	science	SU
opabloska	acute accent	SU
opaf	acute	AQ
opagaf	sibilant	AQ
opelaf	simple	AQ
opelkaf	na#f	AQ
opelon	just	AV
opeluca	simplicity	SU
opik	scientist	SU
opra	ice	SU
oral	beak	SU
orara	high tide	SU
ord	type	SU
ordaf	typical	AQ
orek	oyster	SU
oria	skull	SU
orikaf	desolate	AQ
ormuks	witticism	SU
ormus	lively	PA
orna	pylon	SU
orpa	custom	SU
ors	anagram	SU
ortlik	devil	SU
oruga	stamen	SU
osta	affix	SU
ostik	besides	AV
ota	number	SU
ovopaf	logical	AQ
ox	oh	IJ
oxaf	cynical	AQ
oxam	exclusively	AV
oxi	gender	SU
oxila	generation	SU
oy	bonus	SU
ozé	protect	VT
ozwá	quote	VT
ozwaks	quotation	SU
paedá	pad	VT
paelpá	sweat	VI
pailtaal	fir	SU
pailtega	cone	SU
pailtegaal	pine	SU
pakera	share	SU
pako	faction	SU
pakof	partisan	AQ
pakon	partially	AV
pakt	part	SU
pakudara	dues	SU
paldel	palladium	SU
palik	buddy	SU
palsotikeem	judiciary	SU
pand	lower-arm	SU
papik	pope	SU
partik	pastor	SU
parvuuca	cleanliness	SU
pastá	seesaw	VT
pasú	belong	VT
pata	account	SU
patá	calculate	VT
patasiko	meter	SU
patcta	country	SU
patctoy	landscape	SU
pauray	eyelash	SU
pawé	be indignant	VI
pebú	explain	VT
pegaf	greedy	AQ
pegon	eagerly	AV
peguca	avidity	SU
pelaf	incidental	AQ
perdoé	dip	VT
pereaksat	July	SU
perfejul	shoe	SU
permaxe	embassy	SU
permik	ambassador	SU
permikeba	embassy	SU
permú	acclaim	VT
peroda	cassette	SU
peroy	seven	AN
persaal	oak	SU
pertor	armour	SU
perzuca	commotion	SU
peyak	farm	SU
peyara	club	SU
pez	nose	SU
pezay	snout	SU
pezta	sense	SU
peztaka	feel	SU
peztakevaf	romantic	AQ
peztalé	feel	VT
peztalí	give off an odour	VT
peztoraf	sagacious	AQ
pí	come	VI
piaal	palm	SU
piako	velvet	SU
pida	gill	SU
pij	ceiling	SU
pikay	sill	SU
pilkaf	own	AQ
pilkon	personally	AV
pilkot	ownership	SU
pilkotik	farmer	SU
pilkovaf	apart	AQ
pilkovon	also	AV
pilkovoy	attribute	SU
piluda	beach	SU
pimtara	description	SU
pinaf	little	AQ
pinapaf	lowercase	AQ
pinepuca	minority	SU
pinga	flea	SU
pinta	detail	SU
pintik	baby	AQ
piod	tripe	SU
pira	advent	SU
piute	mail	SU
piutef	postal	AQ
piutefoxiega	money order	SU
piutegwilt	postal rates	SU
piuteliwa	postcard	SU
piutexe	post-office	SU
plabaf	adverse	AQ
plastuba	daisy	SU
plataé	spur	VT
plataera	impetus	SU
plataes	evocative	PA
platí	push	VT
plaxaf	supple	AQ
play	post	SU
plé	draw out	VT
plekú	insert	VT
pliera	amenity	SU
plinaf	agreeable	AQ
plinon	agreeably	AV
plinuca	pleasantness	SU
plivol	python	SU
plo	pipe	SU
ploda	table-cloth	SU
plor	corridor	SU
ploté	brandish	VT
ploz	wrinkle	SU
plozá	furrow	VT
po	force	SU
poá	cultivate	VT
poaf	dynamic	AQ
pobaxá	abuse	VT
poegol	hedgehog	SU
pofera	administration	SU
pofesik	manager	SU
pojá	delight in	VT
pok	nearby	PP
pokeon	close	AV
pokeyaf	adjacent	AQ
ponara	composition	SU
ponhacka	niche	SU
ponkik	follower	AQ
poon	strongly	AV
poopa	mechanics	SU
poopik	mechanic	SU
porá	honour	VT
poraf	honourable	AQ
porfeon	consequently	AV
poriol	penguin	SU
portaf	distressing	AQ
porton	painfully	AV
poruca	honour	SU
poz	ball	SU
pozla	plate	SU
pragá	rub	VT
pragucara	abrasion	SU
pragucas	abrasive	PA
prantaf	firm	AQ
pratcol	llama	SU
praxa	hormone	SU
preima	lawn	SU
prejá	murmur	VT
preksaf	normal	AQ
preksayaf	normative	SU
pretcaal	poplar	SU
preyutá	conceal	VT
pridú	circulate	VI
pridura	circulation	SU
prijust	jaw	SU
prilara	account	SU
prioka	heath	SU
prolk	standard	SU
prostelay	dynasty	SU
prostelayaf	dynastic	AQ
prostewa	tradition	SU
puida	vexation	SU
puilé	quilt	VT
puiles	sharp	SU
puilesiki	sting	SU
pujé	float	VI
puk	dogma	SU
pula	class	SU
puloda	parliament	SU
pulotaf	classic	AQ
pultel	plutonium	SU
pulva	speech	SU
pulvaf	oral	AQ
pulveka	expression	SU
pulví	speak	VI
pulviropa	grammar	SU
pulvisik	orator	SU
pumá	wet	VT
pumake	rosemary	SU
pumkik	angel	SU
punta	oil	SU
purda	allegory	SU
purdaf	allegoric	AQ
purga	bribery	SU
puron	genuinely	AV
pursara	sanction	SU
puruca	sincerity	SU
pustayan	roasted	PA
putc	vertebra	SU
putcé	spit	VT
putcol	antelope	SU
puve	fun	SU
puvé	please	VT
puxima	rape	SU
puze	menstruation	SU
puzitá	sneeze	VI
ra	element	SU
raba	industry	SU
rabaf	industrial	AQ
rabandé	equip	VT
rabaté	ascertain	VT
rabik	industrialist	SU
radá	assimilate	VT
radimif	following	AQ
radimiik	offspring	SU
radimlaní	travel	VT
ralaku	beam	SU
ralk	swelling	SU
ralkkiraf	hunch-backed	AQ
ralkkirik	hunchback	SU
ralom	ghetto	SU
ralpa	glass	SU
ralpoda	showcase	SU
ralta	rose	SU
raltukaf	pink	AQ
ramba	monsoon	SU
rambik	admiral	AQ
raneta	cherry	SU
ranetaal	cherry-tree	SU
ranhé	stand	VI
rantaf	breakable	AQ
rapalaf	compatible	AQ
rapaluca	compliance	SU
rape	in accordance with	PP
rapor	stone	SU
raporka	boulder	SU
rasek	tower	SU
rast	margin	SU
rastaf	marginal	AQ
rastoka	cabinet	SU
rav	average	SU
ravaldá	insure	VT
ravaldasik	insurer	SU
ravalduga	by-laws	SU
ravaldunaf	certain	AQ
ravé	teach	VT
ravlem	word	SU
ravlemak	dictionary	SU
ravlemeem	vocabulary	SU
ravlemolkaf	radical	AQ
rayoligá	perish	VI
razama	crow	SU
razamié	caw	VI
razdá	develop	VT
razeka	plate	SU
razopa	chemistry	SU
razopik	chemist	SU
rea	agglomeration	SU
rebava	wall	SU
recela	stage	SU
redakik	captain	SU
redú	create	VT
reduraf	creative	AQ
redusik	creator	SU
refema	strap	SU
regala	incident	SU
regelta	flour	SU
regrá	trace	VT
regvel	arabesque	SU
reila	high school	SU
rekleda	casserole	SU
rekodaf	sophisticated	AQ
rekola	period	SU
rekolaca	periodical	SU
rekolaf	periodical	AQ
relandé	amuse	VT
relandera	amusement	SU
relatcesik	agitator	SU
relida	pyramid	SU
relingá	commit aggression	VT
relingara	aggression	SU
relingas	aggressive	PA
relingasik	aggressor	SU
relkaca	abhorrence	SU
relmé	betray	VT
relt	muscle	SU
relvá	delete	VT
rem	through	PP
remafif	clear	AQ
remalt	course	SU
remay	weft	SU
remayé	weave	VT
remburé	transport	VT
remel	bromine	SU
remrú	punch	VT
remsuté	translate	VT
remzilira	delivery	SU
rena	love	SU
rená	love	VT
renarú	make love	VI
renas	lover	PA
rendaf	draught	AQ
renta	carpentry	SU
repalé	sigh	VI
repalera	sigh	SU
rera	diagnosis	SU
restali	maxim	SU
retalk	stallion	SU
retik	candidate	AQ
revava	district	SU
reya	blackberry	SU
reyaal	mulberry-tree	SU
reza	beet	SU
rezold	radish	SU
riaf	precious	AQ
riba	cage	SU
ribasusik	goalkeeper	SU
ribiegaf	wonderful	AQ
ribiegon	marvellously	AV
ribuda	cobra	SU
ric	rye	SU
ricol	shark	SU
ricom	spring-mattress	SU
rictá	authorize	VT
rictara	authorization	SU
rictela	authority	SU
rictulokaf	authoritative	AQ
riduratwa	dunning-letter	SU
rielcek	morning	SU
rient	saucer	SU
rieta	idea	SU
rietava	ideal	SU
rietavaf	ideal	AQ
rietova	theory	SU
rietunuca	utopia	SU
rifta	louse	SU
rigavá	erect	VT
rigotaf	fundamental	AQ
rija	pants	SU
rijn	rostrum	SU
rijust	steppe	SU
ringaf	transparant	AQ
rinta	caprice	SU
rinú	thee and thou	VT
rion	seldom	AV
riozaf	nasty	AQ
riozuca	aversion	SU
ripindara	craziness	SU
riska	delta	SU
ristara	tightness of the chest	SU
ristura	administration	SU
risturaf	administrative	AQ
ristusik	administrator	SU
risu	amulet	SU
riulk	Rhine barge	SU
riva	circus	SU
rivla	narcissus	SU
riwe	almost	AV
riwé	be worthy of	VT
riwera	merit	SU
rixeda	tangerine	SU
riz	lung	SU
roatalera	alteration	SU
rob	livelihood	SU
robuda	aureole	SU
roda	chain	SU
rodaf	dry	AQ
rodaxá	distrust	VT
rodaxas	suspicious	PA
rodaxasuca	suspicion	SU
rodj	chess	SU
rodjgá	look askance	VI
rodosten	acceptable	PA
rofavé	overtax	VT
rofavera	abuse	SU
rofaves	erroneous	PA
rofaveson	by mistake	AV
roga	jewel	SU
rogadolesik	jeweller	SU
rogdala	slate	SU
rogilden	audible	PA
roida	splinter	SU
rojú	defend	VT
rojuiken	recommendable	PA
rojula	apology	SU
rojusik	defender	SU
roka	law	SU
rolustes	solvent	PA
rom	orgasm	SU
ronalen	acceptable	PA
rondara	drumming	SU
ronduza	basil	SU
ronef	right	AQ
roneka	east	SU
roneon	on the right	AV
ronkaf	faithful	AQ
rontaf	direct	AQ
rontagentim	rectangle	SU
rontagentimaf	right-angle	SU
rontion	directly	AV
ropé	attend	VT
ropes	careful	PA
ropesik	nurse	SU
ropexe	hospital	SU
ropojaf	confrontational	AQ
roseotan	obtainable	PA
rostaza	monster	SU
rostela	vegetable	SU
rostinttwa	credentials	SU
rotabdiwis	foreseeable	PA
rotaca	bad	SU
rotaf	bad	AQ
rotapstá	curse	VT
rotarapenis	reconcilable	PA
rotatrakus	pessimist	PA
rotatrakusuca	pessimism	SU
roti	be able to	SU
rotir	maybe	AV
rotis	possible	PA
rotoda	inconvenience	SU
roton	badly	AV
rotulis	drinkable	PA
rotuxá	lie	VI
rotuxara	lie	SU
rotuxas	mendacious	PA
rotuxasik	liar	SU
rovansas	accessible	PA
rovidaf	frolic	AQ
roxanhá	chew	VT
rubdá	appeal to	VT
rubiá	print	VT
rubiasik	printer	SU
rubiaxe	printing office	SU
rubixa	drizzle	SU
rucá	file	VT
rucasiki	file	SU
rucka	fern	SU
rude	menu	SU
rudist	chamber	SU
rué	hurry	VT
ruelgá	air	VT
ruft	earthquake	SU
rujá	suppress	VT
rujaal	lilac	SU
rujod	cloud	SU
rukom	water	SU
rukuzaf	subtle	AQ
ruldá	hold	VT
rumel	nickel	SU
rumeugal	childhood	SU
rumgaca	allergy	SU
runda	location	SU
rundara	arrangement	SU
runta	wave	SU
runtama	ripple	SU
runza	fishing-rod	SU
ruolz	ozone	SU
rupé	consult	VT
rupeko	restistance	SU
rupolya	she-bear	SU
rupté	depend	VT
ruptes	dependent	PA
ruse	cigar	SU
ruseta	cigarette	SU
rustolera	watering	SU
rustolesiki	watering-can	SU
rutc	sore	SU
ruxaf	vegetable	AQ
ruyat	alcohol	SU
ruyatakola	alcoholism	SU
ruzadera	assault	SU
ruzek	timbre	SU
rwama	affray	SU
rwamá	be at loggerheads	VT
saá	excite pity	VT
saba	chocolate	SU
sabé	measure	VT
sadj	chisel	SU
sadjá	chase	VT
safta	week	SU
saftaf	weekly	AQ
sagaf	faithful	AQ
saguca	adherence	SU
saipuca	gladness	SU
salk	stuff	SU
salma	frog	SU
salt	current	SU
san-aluboy	fifteen	AN
san-anhustoy	eighteen	AN
san-balemeaf	fourteenth	AQ
san-balemoy	fourteen	AN
san-bareaf	thirteenth	AQ
san-baroy	thirteen	AN
san-lerdoy	nineteen	AN
san-peroy	seventeen	AN
san-taneaf	eleventh	AQ
san-tanoy	eleven	AN
san-tevoy	sixteen	AN
san-toleaf	twelfth	AQ
san-toloy	twelve	AN
sane	folk	SU
saneaksat	October	SU
sanef	popular	AQ
saneg	public	SU
sanegá	announce	VT
sanelia	population	SU
sanerotievik	democrat	SU
sanoy	ten	AN
santa	caress	SU
santá	caress	VT
santaneaksat	November	SU
santolea	dozen	SU
santoleaksat	December	SU
sapaf	coherent	AQ
sarandaxo	waiting-room	SU
sardaf	adolescent	AQ
sardik	adolescent	AQ
savsula	archaism	SU
savsuté	prescribe	VT
saxa	couch	SU
saya	down	SU
sayakaxe	barracks	SU
sayakik	soldier	SU
sayelasiki	muzzle	SU
sayudara	activism	SU
sayudasik	activist	SU
sazda	supposition	SU
sazdaf	hypothetical	AQ
sebeka	wax	SU
sebeká	wax	VT
sedme	according to	PP
sedok	shawl	SU
sekiasik	trainer	SU
sel	fog	SU
selá	look after	VT
selaropik	doctor	SU
selasikionha	chemist's shop	SU
selt	society	SU
seltaf	social	AQ
selteva	socialism	SU
semá	burst	VT
sembel	antimony	SU
semint	clarion	SU
sendá	congratulate	VT
senhá	go down	VI
senhé	lie	VI
sensuca	affluence	SU
seotá	get	VT
seotara	accession	SU
seramon	eagerly	AV
seramuca	enthusiasm	SU
serpega	eel	SU
sersikya	princess	SU
sersikye	prince	SU
sespa	weight	SU
severokelda	airway	SU
severoopa	aeronautics	SU
severosarva	airline	SU
severotcordik	skyjacker	SU
severototara	aviation	SU
severoxo	airport	SU
severoza	airlift	SU
sfi	yam	SU
sfiannu	rheumatism	SU
siabeks	present	SU
siak	perspective	SU
siakraf	perceptible	AQ
sida	ink	SU
sidayaf	terrestrial	AQ
sidj	remorse	SU
sidopa	geology	SU
sidopaf	geological	AQ
sidot	ground-floor	SU
sielcek	evening	SU
sieleldeon	tomorrow evening	AV
sielestura	evening meal	SU
sielkiava	good evening	SU
sielon	in the evening	AV
siké	sabotage	VT
sin	they	PN
sinaf	their	AQ
sinka	food	SU
sinká	feed	VT
sintaf	her	AQ
siput	thirst	SU
siputé	be thirsty	VI
siroda	bindweed	SU
sirta	ball	SU
siskava	praise	SU
siské	hire	VT
siudá	swarm	VI
siuva	spring	SU
sivakuca	abundance	SU
skael	foam	SU
skalé	excuse	VT
skalewé	excuse me	VI
skaltaf	indistinct	AQ
skalté	confuse	VT
skera	lust	SU
skes	exciting	PA
skintuca	routine	SU
skoka	balalaika	SU
skotcá	quiver	VI
skrombol	agouti	SU
skú	execute	VT
skujé	intrigue	VI
skujera	plot	SU
skujesik	intriguer	SU
sladu	cashewnut	SU
sladuaal	mahogany	SU
slakol	mouse	SU
slik	too	AI
sma	biscuit	SU
soá	fold	VT
soaks	fold	SU
soawé	retreat	VI
soist	torrent	SU
sok	condition	SU
soka	state	SU
sokasane	republic	SU
sokí	appear	VI
sokitis	essential	PA
sokra	proboscis	SU
sokuda	rhyme	SU
solgabeyá	saw	VT
solgabeyaks	sawdust	SU
solgabeyasiki	saw	SU
solgesiá	dissociate	VT
soli	team	SU
solkurera	divorce	SU
sollipá	rip	VT
soloksaca	abstraction	SU
soloksaf	abstract	AQ
solokseropa	mathematics	SU
solokson	abstractly	AV
soloksuca	abstraction	SU
solovaf	absurd	AQ
solovuca	absurdity	SU
solpasik	distiller	SU
soltiolté	eradicate	VT
soluma	distance	SU
solzá	roast	VT
solzarté	divide	VT
sona	crown	SU
soná	crown	VT
sorela	adjective	SU
sorelaf	adjectival	SU
soriuca	haste	SU
sorla	sheaf	SU
sorta	licence	SU
sos	albumin	SU
sosakola	albumose	SU
sosina	protein	SU
sostá	insulate	VT
sotcé	stretch	VT
sotcenuca	tension	SU
sowe	slang	SU
soy	anaconda	SU
soyaci	hook	SU
soyor	soft-shelled almond	SU
soyoraal	almond	SU
soyutaf	severe	AQ
soyutik	ascetic	SU
soyutuca	severity	SU
soza	balcony	SU
spaf	intact	AQ
spedol	seal	SU
spikol	yak	SU
sposuca	reputation	SU
sprela	peat	SU
spunté	grate	VT
stajok	apostrophe	SU
staké	massacre	VT
staksa	errand	SU
staksasik	advertiser	SU
staksé	send	VT
staksera	submission	SU
staksesik	sender	SU
stama	linen	SU
stapé	suffice	VT
starka	bench	SU
starkot	small bench	SU
starpaal	avocado-tree	SU
stasik	chauffeur	SU
stivawé	be quiet	VI
stoga	fraction	SU
stona	coping	SU
storka	headlight	SU
storn	tapestry	SU
storná	cover	VT
straga	note	SU
stragá	make a note	VT
stragela	notice	SU
stravok	notion	SU
strumbaf	accidented	AQ
stubé	alarm	VT
stubes	scare-monger	PA
stujera	check	SU
stujesik	guard	SU
stupkik	lunatic	AQ
stute	dance	SU
stuté	dance	VT
stuva	adventure	SU
sudaf	fat	AQ
suesta	snapweed	SU
sugá	strive for	VT
sugara	effort	SU
sugawalk	mourning	SU
sugdá	sign	VT
sugdaks	signature	SU
sugdala	meaning	SU
sugdalá	imply	VT
sugdava	mark	SU
sugdavá	signal	VT
sugdeya	badge	SU
sugduka	shield	SU
suka	wind	SU
suké	blow	VT
sukera	blowing	SU
sukoná	ventilate	VT
sukonasiko	electric fan	SU
sul	fountain	SU
sumepulví	telephone	VT
sumepulvisiki	telephone	SU
sumesuteks	telegram	SU
sumesutesiki	telegraph	SU
sumewisiki	TV	SU
suola	screw	SU
suolasiki	screwdriver	SU
suptaf	lay	AQ
suptik	layman	SU
surk	alarmclock	SU
susik	guard	SU
susta	quiver	SU
suté	compose	VT
suteka	orthography	SU
sutelá	edit	VT
sutelaks	editorial office	SU
sutelara	composition	SU
suteptik	secretary	AQ
suteroteem	literature	SU
suxá	dig	VT
suxaca	cave	AQ
sveri	bird	SU
sverioc	little bird	SU
swalot	column	SU
swava	spirit	SU
swavadrunaropa	psychoanalysis	SU
swavadrunaropaf	psychoanalytic	AQ
swavaf	psychic	AQ
swavakola	psychosis	SU
swavaroperopa	psychiatry	SU
swavaroperopaf	psychiatric	AQ
swavay	mentality	SU
swavopa	psychology	SU
swavopaf	psychological	AQ
swavuca	psyche	SU
ta	da so	CJ
taam	suspender	SU
tabexaf	eminent	AQ
tacé	turn	VT
tadava	continent	SU
tael	moon	SU
tagelton	justly	AV
taksul	rod	SU
taktiz	yucca	SU
tal	money	SU
talá	fly	VI
talga	tooth	SU
talgiwola	tooth-brush	SU
talgopik	dentist	SU
talgukay	lace	SU
talpey	programme	SU
talteka	west	SU
tama	chorus	SU
tamaf	harmonious	AQ
tamava	world	SU
tame	universe	SU
tan	a	AT
tanaca	unit	SU
tanaf	unique	AQ
tanameyá	roll	VT
tanamú	roll	VI
tanboyon	with one accord	AV
tandé	stick	VI
taneaf	first	AQ
taneagadesik	president	SU
taneaksat	January	SU
tanealik	pioneer	AQ
tanealubek	big toe	SU
taneanasbalaf	elder	AQ
taneask	initiative	SU
taneasté	inaugurate	VT
taneastera	beginning	SU
taneatí	preside	VT
taneatisik	chairman	SU
taneaviel	Sunday	SU
taneavielon	on Sundays	AV
taneodaal	primeval forest	SU
taneodaf	primary	AQ
taneon	first	AV
taneor	prototype	SU
tankomaf	monotonous	AQ
tankotaks	aggregate	SU
tankotara	French academic qualification	SU
tanoy	one	AN
tantazukot	uniform	SU
taray	comet	SU
targuca	glamour	SU
tari	crowd	SU
tarizá	dedicate	VT
tarja	favour	SU
tarká	respect	VT
tarkaf	respectful	AQ
tarkuca	respect	SU
taruté	avoid	VT
tasila	guitar	SU
tavera	lesson	SU
tavesik	professor	SU
tavesikya	mistress	SU
tawa	earth	SU
tawaday	country	SU
tawadayik	peasant	SU
tawamidura	agriculture	SU
tawamiduraf	agricultural	AQ
tawamiduropaf	agricultural	AQ
tawamiduropik	agronomist	SU
tawamidusik	farmer	SU
tawavaf	terrestrial	AQ
tawavo	territory	SU
tawavopa	geography	SU
tawavopaf	geographic	AQ
tawetc	terrace	SU
tawopa	agronomics	SU
tawova	field	SU
taxa	bravely	SU
taya	field	SU
tayi	cloth	SU
tazá	boycott	VT
tazuk	form	SU
tazuká	form	VT
tazukoy	formula	SU
tazukoyé	articulate	VT
tca	trick	SU
tcabanhé	chase	VT
tcabanhera	hunt	SU
tcabanhesik	hunter	SU
tcaf	artificial	AQ
tcala	watermark	SU
tcatexo	bathroom	SU
tcazaf	dear	AQ
tcazé	reflect	VT
tcazedaks	reflection	SU
tceka	arrow	SU
tcepá	gallop	VI
tciamaf	affected	AQ
tcicesik	assistant	SU
tcilaxe	museum	SU
tcilk	essay	SU
tciné	solve	VT
tcinera	solution	SU
tciugo	hawkbit	SU
tciumba	sand	SU
tcobá	operate	VT
tcobara	operation	SU
tcoké	watch	VT
tcol	pheasant	SU
tcor	cheek	SU
tcotá	shiver	VI
tcoza	shed	SU
tcubda	mica	SU
tcuga	hymen	SU
tculk	volcano	SU
tcumivaf	insubordinate	AQ
tcumpaf	famous	AQ
tcunaca	deformity	SU
tcunaf	crippled	AQ
tcunik	sufferer	AQ
tcunuca	weakness	SU
tcuxa	verdict	SU
tegi	act	SU
tegilak	share-capital	SU
tegilik	shareholder	SU
tegira	share	SU
tegirá	drive	VT
tegiraf	active	AQ
tegirik	assets	AQ
tegiruca	activity	SU
tegis	active	PA
tegivsutesik	notary	SU
tegulá	agitate	VT
tegulara	commotion	SU
telaf	above-board	AQ
teliz	article	SU
telvung	shutter	SU
tema	complaint	SU
temé	complain	VT
temesik	accuser	SU
tena	term	SU
tenanteyá	extinguish	VT
teneká	conduct	VT
tenekara	regulations	SU
teniskaf	everlasting	AQ
tenkaf	acerbic	AQ
tenon	at last	AV
tenú	stop	VT
tenuké	finish	VT
tenukenaf	perfect	AQ
tenuwé	come to an end	VI
teraf	elastic	AQ
terca	-hrysanthemum	SU
teri	bacillus	SU
terigé	crawl	VI
terktá	listen	VT
terktasik	listener	SU
terktasikeem	audience	SU
term	film	SU
termil	salmon	SU
tev-sanoy	sixtieth	AN
teveaksat	June	SU
teveaviel	Friday	SU
tevoy	six	AN
tex	palm	SU
tey	fire	SU
teyé	flame	VI
teyka	flame	SU
teyxo	hearth	SU
teza	model	SU
tezodá	model	VT
tí	zanugalaf be on duty	AQ
tialt	pimple	SU
tiannaf	rigid	AQ
tiavé	suggest	VT
tidepitá	shrug	VI
tidlaní	ascend	VT
tidtalá	take wing	VI
tiduk	aplomb	SU
tidumá	climb	VI
tie	gas	SU
tienaf	lynx-eyed	AQ
tiguaf	gaunt	AQ
tij	moss	SU
tila	attitude	SU
tilbu	heresy	SU
tildera	holiday	SU
tilderugal	spare time	SU
tildewé	repose	VI
tildewera	calm	SU
tildexe	resting-place	SU
tilerda	torch	SU
tilik	pattern	SU
tinefká	communiceren	VI
tinefkara	communion	SU
tinida	larder	SU
tinté	whisper	VT
tiojesiki	handkerchief	SU
tiolté	abstract	VT
tiorn	pie	SU
tipaf	bitter	AQ
tipoké	shave	VT
tipu	hygiene	SU
tipuf	hygienic	AQ
titická	define	VT
titickaf	fixed	AQ
titosipé	cast off	VT
tiú	manoeuvre	VT
tiv	boat	SU
tixolaf	discreet	AQ
tixulé	flirt	VI
tiyá	articulation	VT
tiyara	pronouncing	SU
tizuca	violence	SU
toa	leaf	SU
toba	glove	SU
tod	affair	SU
toidesik	spy	SU
tok	what kind of	AI
toka	grub	SU
tokcoba	what	PN
toklize	where	AV
tokoda	quantity	SU
tokon	vil ? how are	you?
tokote	how many	AV
toktan	who	PN
tokte	abashment	SU
tokviele	when	AV
tol-decemoy	two hundred	AN
tol-saneaf	twentieth	AQ
tol-sanoy	twenty	AN
tolaskí	remake	VT
tolaskira	repetition	SU
tolawí	reappear	VI
tolbelí	read again	VT
toleaf	second	AQ
toleaksat	February	SU
toleaviel	Monday	SU
toleavielon	on Mondays	AV
toleodaf	accessory	AQ
tolgení	invade	VT
tolkalí	repeat	VT
tolke	infinitely	AV
tolkrafol	bicycle	SU
toln	kerosene	SU
tologay	binoculars	SU
tologe	pair	SU
tolokik	par	AQ
tolveynasbeikya	greatgranddaughter	SU
tolveynasbeikye	greatgrandson	SU
tolveynutikya	grand-niece	SU
tolveynutikye	grand-nephew	SU
tolwá	earn back	VT
tolwí	see again	VT
toma	occasion	SU
ton	at	PP
tori	by	PP
torigí	consider	VT
torkeva	fascism	SU
torkik	dictator	SU
torsta	thorn	SU
tota	ship	SU
totá	navigate	VI
totarajoya	waterway	SU
totasik	sailor	SU
totcidaf	avaricious	AQ
toteem	fleet	SU
tourka	pond	SU
tovok	partridge	SU
tovol	rat	SU
towá	develop	VI
toz	guyundé set going	VI
toza	beginning	SU
tozekik	bandit	AQ
tozú	begin	VT
tra	arc	SU
trabiangon	comfortably	AV
trak	pansy	SU
trakopa	philosophy	SU
trakú	think	VT
tral	electricity	SU
tralaf	electric	AQ
traliaxe	exchange	SU
tralo	electron	SU
tranodaf	careful	AQ
tranoduca	discretion	SU
trapamaal	peanut	SU
trapova	pavilion	SU
trasí	find	VT
traspú	flow	VI
trayka	chest	SU
tredú	pick	VT
trelaf	brief	AQ
tresenikya	hooker	SU
tresera	prostitution	SU
tresexe	brothel	SU
tresiki	pick-axe	SU
tride	ray	SU
trideks	streak	SU
tridenaf	striated	AQ
triguca	prosperity	SU
triln	marble	SU
trink	beam	SU
tritaf	stringent	AQ
triva	glass	SU
troba	sin	SU
trobá	sin	VI
trobasik	sinner	SU
trobindá	give up	VT
troci	bugle	SU
trogarn	expression	SU
tronká	braid	VT
tropa	helix	SU
troskol	hippo	SU
trovgá	overthrow	VT
troyta	flower bed	SU
truga	drum	SU
truk	prospectus	SU
trula	watch	SU
trulaveel	needle	SU
trulonha	watchmaker	SU
trumá	care about	VT
trumaf	attentive	AQ
trumi	wheelbarrow	SU
trumuca	attention	SU
truza	abdomen	SU
tsage	poppy	SU
tsay	boa	SU
tselka	spanner	SU
tselkot	keyboard	SU
tsent	broom	SU
tsenté	sweep	VT
tso	ion	SU
tsuné	object	VT
tsunesikeem	opposition	SU
tsurk	chorus	SU
tuabdá	irrigate	VT
tuatrisá	grow	VT
tubalká	automate	VT
tubaspesá	feed	VT
tubecá	reason	VT
tubelkusas	oppressive	PA
tubertrawé	tan	VI
tubi	coat	SU
tublafotawé	yellow	VI
tubliá	animate	VT
tubliara	animation	SU
tuboná	stultify	VT
tubonawé	become dull	VI
tuca	fantasy	SU
tudala	blister	SU
tuebeltá	blacken	VT
tuesá	complicate	VT
tufa	fortune	SU
tufedá	refresh	VT
tufentá	deaden	VT
tufentasiko	refrigerator	SU
tufentawé	catch cold	VI
tugabentá	afflict	VT
tugadiá	prepare	VT
tugalá	cure	VT
tugemá	refine	VT
tuglagá	blunt	VT
tugoá	grind	VT
tugoasik	miller	SU
tugoasiko	mill	SU
tugol	albatross	SU
tuidulara	heating	SU
tuidulasiko	primus	SU
tuivú	fart	VI
tuivura	fart	SU
tujbora	service	SU
tujdé	preach	VT
tujpastik	monk	SU
tujradik	bishop	SU
tukará	clean	SU
tuke	thanks to	PP
tukerawé	blush	VI
tuklarmá	pervert	VT
tukográ	dishevel	SU
tukotrá	fill	SU
tukrenugas	emotional	PA
tulidawickawé	acclimate	VI
tulivá	bend	VT
tuloadastirbá	aggravate	VT
tulodabrotcá	lengthen	VT
tulodontiná	elevate	VT
tulogijá	increase	VT
tulogijara	increase	SU
tulokaliara	acceleration	SU
tulokalias	accelerative	PA
tulolistá	embellish	VT
tulon	for example	AV
tulopiná	decrease	VT
tulopoá	amplify	VT
tulopoasiki	amplifier	SU
tulopwertá	thicken	VT
tulubesá	drop	VT
tulukrá	mature	SU
tulukrawé	ripen	VI
tumoavá	gild	VT
tumtaf	holy	AQ
tunalesá	drive through	VT
tunereva	abolitionism	SU
tunerevik	abolitionist	SU
tunigá	vex	VT
tunoelá	update	VT
tunuyalá	prepay	VT
tunuyalanaf	post-paid	AQ
tunuyalara	liberation	SU
tunuyalasik	rescuer	SU
tuomá	decrease	VT
tuopasiki	knife-grinder	SU
tuoriká	dim	VT
tuorikawé	darken	VI
turapalawé	abide by	VI
turci	vulture	SU
turestuca	influence	SU
turodá	dry	VT
turolá	falsify	VT
turontá	murder	VT
tursia	archipelago	SU
turwi	alimony	SU
tusanegá	publish	VT
tusanegara	publicity	SU
tutegisá	actuate	VT
tutená	cease	VT
tutrovgá	relay	VT
tutsoká	amplify	VT
tuvel	door	SU
tuvertá	regulate	VT
tuviá	slow	VT
tuviawé	slow	VI
tuvlardá	empty	VT
tuwarzá	renew	VT
tuwarzara	renewal	SU
tuwava	nature	SU
tuwavaf	natural	AQ
tuwavon	naturally	AV
tuwawá	impoverish	VT
tuwiiská	dazzle	VT
tuyatkawé	be infuriated	VI
tuzaf	agile	AQ
tuzatá	magnetize	VT
tuzawodá	exempt	VT
tuzda	commission	SU
tuzioná	slander	VT
tuzwá	pale	VT
tuzwawé	fade	VI
twa	letter	SU
twá	crack	VT
twara	crack	SU
tweem	piece of mail	SU
twern	pavement	SU
twoda	circular	SU
twom	affiliate	SU
u	dot	SU
ú	exert	VT
ucom	pocket	SU
uculé	suspect	VT