@rowCount	1316
w	d	t
Lojban	toki Losupan. en la toki pona. taso la toki pona ala	toki
kijetesantakalu	any animal from the Procyonidae family, such as raccoons, coatis, kinkajous, olingos, ringtails and cacomistles. Also may reference an armadillo, although this is not official. not obsolete, never used seriously.	toki
... o tawa tomo sina!	... go to your house!	phrase
a a a! ni li musi.	Hahaha! That's funny.	phrase
a! akesi li wile moku e mi!	Ahh! The dinosaur wants to eat me!	phrase
ijo ike li lon monsi mi.	Bad things are behind me.	phrase
ijo li lon oko mi.	Something is in my eye.	phrase
ijo li lukin e mi.	Something is watching me.	phrase
ilo li lon poki.	The tools are in the container.	phrase
jan Lisa o, toki.	Hello, Lisa.	phrase
jan Susan li nasa.	Susan is crazy.	phrase
jan ike li kama la o seli e lipu ni.	If the enemy comes, burn these papers.	phrase
jan ike li utala e ona mute.	An enemy is attacking them.	phrase
jan ike ni li jo e len nasa.	That bad person has strange clothes.	phrase
jan jelo laso lili li kama tan sewi.	A little green person came from the sky.	phrase
jan laso jelo lili li kama tan sewi. /	A little green person came from the sky.	phrase
jan lawa li moku e telo jaki.	The leader drank dirty water.	phrase
jan lawa pi tomo tawa telo li moku.	The captain of the ship is eating.	phrase
jan li lukin sama pipi.	People look like ants.	phrase
jan li pona.	People are good.	phrase
jan lili li lukin e jan suli.	Children watch adults.	phrase
jan lili pi jan Keli li musi.	Keli's child is funny.	phrase
jan mute li kama.	Many people came.	phrase
jan mute lili li kama.	A small amount (of) people are coming.	phrase
jan pi nanpa wan li lon.	The first person is here.	phrase
jan pona mi li lon poka mi.	My friend is beside me.	phrase
jan seme li lon? / jan seme li lon ni?	Who's there?	phrase
jan seme li olin e sina?	Who loves you?	phrase
jan seme pi kulupu ni li suli?	Which people of this group are important?	phrase
jan sin li kama ala kama?	Are more people coming?	phrase
kalama musi pi jan Enja li pona.	Enya's music is good.	phrase
kasi kule li pona lukin.	Flowers are pretty.	phrase
ken la jan Susan li kama.	Maybe Susan will come.	phrase
ken la ona li lon tomo sona.	Maybe he's in school.	phrase
kili li moku li pona.	Pineapple is a food and is good.	phrase
kule laso loje li pona tawa mi.	I like the color purple.	phrase
kule loje laso li pona tawa mi. /	I like the color purple.	phrase
kule seme li pona tawa sina?	Which color do you like?	phrase
linja mi li telo.	My hair is wet.	phrase
lipu ni li pilin lete.	This paper feels cold.	phrase
lon	to be in/at/on, to exist; in, at, on	word
lon ala	no	phrase
lupa ni li suli.	That hole is big.	phrase
ma li lon anpa mi.	The land is beneath me.	phrase
mama meli o awen.	Mama, wait.	phrase
mani pi ma ante li pona tawa mi.	I like currency of other nations.	phrase
mi jan pi toki pona.	I am a Toki Ponan.	phrase
mi jo e ilo.	I have a tool.	phrase
mi jo e tomo tawa tu.	I own two cars.	phrase
mi kama tan ma Elopa.	I come from Europe.	phrase
mi ken ala kute e toki sina.	I can't hear your talking.	phrase
mi ken ala lape.	I can't sleep.	phrase
mi kin wile tawa tomo mi.	I still want to go to my house.	phrase
mi lon.	Yes, i do.	phrase
mi lukin ala e poki laso.	I don't see the blue bag.	phrase
mi lukin e ma lon poka pi jan pona mi.	I look at the land with my friend.	phrase
mi lukin e ma poka jan pona mi.	I look at the land with my friend.	phrase
mi lukin e waso tu wan.	I saw three birds.	phrase
mi moku.	I eat. / I am food.	phrase
mi mute li moku e telo nasa mute.	We drank a lot of vodka.	phrase
mi mute li pana e moku tawa ona mute.	We gave them food.	phrase
mi mute o moku e kala.	Let's eat fish.	phrase
mi pona ala pona tawa sina?	Do you like me?	phrase
mi pona e ilo suno kepeken ilo lili.	I fixed the flashlight using a small tool.	phrase
mi pona tan ni: mi lon.	I'm okay because I'm alive.	phrase
mi taso li lon.	I'm alone.	phrase
mi tawa (said by person leaving); tawa pona (said by person staying)	good-bye	phrase
mi tawa supa lape.	I'm going to bed.	phrase
mi tawa!	Bye!	phrase
mi wile ala toki tawa sina.	I don't want to talk to you.	phrase
mi wile e ilo moku.	I need a fork.	phrase
mi wile e sitelen ma.	I want the map.	phrase
mi wile e soweli lili.	I want a puppy.	phrase
mi wile pana e ko jaki.	I need to crap.	phrase
mi wile pana e telo jelo.	I need to pee.	phrase
mi wile tawa ma Oselija.	I want to go to Australia.	phrase
mi wile tawa tomo ona kepeken tomo tawa mi.	I want to go to his house using my car.	phrase
mi wile tawa. taso mi ken ala.	I want to go, but I can't.	phrase
moku li pona tawa ona.	He loves to eat.	phrase
mu.	Meow. Woof. Grrr. Moo. (sounds made by animals)	word
mute seme?	how much?	phrase
ni	this, that	word
ni li musi ala musi? musi.	Is that funny? Yes.	phrase
ni li suwi ala suwi?	Is that sweet?	phrase
ni li tawa jan pona mi.	This is for my friend.	phrase
nimi mi li Ken.	My name is Ken.	phrase
o lukin e pipi loje ni.	Look at that red bug.	phrase
o open e lupa.	Open the door.	phrase
o pana e suwi tawa mi!	Give me a lollipop!	phrase
o pilin e uta mi kepeken uta sina.	Kiss me.	phrase
o tawa!	Go!	phrase
o wan!	Unite!	phrase
ona li jan pona pi kalama musi.	He is a good musician.	phrase
ona li moku e kili.	She's eating fruit.	phrase
ona li pali e ni kepeken nasin seme?	How did she make that?	phrase
ona li tawa ala telo.	He didn't go to the lake.	phrase
ona li wile pakala e pipi.	He wants to squish the spider.	phrase
ona mute li  utala toki.	They are arguing.	phrase
pakala!	f-ck! d-mn!	word
pipi li lon ala lon poka mi?	Is a bug beside me?	phrase
pipi li moku e mi.	The mosquito bit me.	phrase
pipi li wile moku e telo.	The bug is thirsty.	phrase
pipi seme li pakala e sina?	Which bug hurt you?	phrase
poki ni li lon jaki.	That bottle is in the dirt.	phrase
pona	yay!, cool, good	word
seli li lon la mi pana e telo tan selo mi.	When it's hot, I sweat.	phrase
sewi li laso.	The sky is blue.	phrase
sina lukin ala lukin e sitelen tawa X-Files?	Do you watch The X-Files?	phrase
sina sona ala sona e toki Inli?	Do you speak English?	phrase
sina suli.	you (are) big/important.	phrase
sina tawa poka jan seme?	Whom did you go with?	phrase
sina wile e moku anu telo?	Do you want food, or do you want water?	phrase
sina wile kama anu seme?	Do you want to come or what?	phrase
sina wile pali e seme?	What do you want to do?	phrase
sina wile toki e tan tawa mi.	You have to tell me why.	phrase
soweli li toki e mu.	Cows say moo.	phrase
suno li lon sewi mi.	The sun is above me.	phrase
telo li pona.	Water is good.	phrase
telo li suli.	The lake is big.	phrase
telo nasa pona!	generic toast	phrase
tenpo pimeja ni la mun li suli.	The moon is big tonight.	phrase
tenpo pimeja pini la mi lukin e sitelen tawa X-Files.	Last night I watched X-Files.	phrase
tenpo suno kama la mi wile pali.	I have to work tomorrow.	phrase
toki Inli	English	phrase
toki pona	to say nice things	phrase
toki pona li pona tawa mi.	I like Toki Pona.	phrase
toki!	Hello!, Hi!, etc.	word
tomo pi mi mute li pakala.	Our house is messed up.	phrase
waso li tawa lon kon.	Birds fly in air.	phrase
(mi meli.) mi olin e meli.	I am a lesbian	phrase
(mi mije.) mi olin e mije.	I am gay (male)	phrase
(ona) li ike	(she/he/it) is bad, I don't like (her/him/it)	phrase
(ona) li pona	(he/she/it) is good, I like (him/her/it)	phrase
(ona) li seme?	what is (she/he) like?	phrase
A: a! sina lukin ala lukin e ijo nasa ni?	Whoa! Do you see that weird thing?	phrase
A: mi mute o tawa.	Let's go.	phrase
A: mi tawa ma Elopa.	I went to Europe.	phrase
Akanisan	Afghanistan	word
Alan	Ireland, Irish Gaelic	word
Alensina	Argentina	word
Anku	Korea, Korean	word
Antola	Andorra	word
Awisi	Haiti, Haitian Creole	word
B: mi kin lukin e ona.	I see it indeed.	phrase
B: mi ken ala. mi kin moku.	I can't. I'm still eating.	phrase
B: pona! mi kin tawa ma Elopa.	Cool! I also went to Europe.	phrase
Ekato	Ecuador	word
Elena	Greece, Greek	word
Epanja	Spain, Spanish	word
Esi	Estonia, Estonian	word
Esuka	Basque Country, Basque	word
I like plants.	kasi li pona tawa mi.	phrase
Ilakija	Iraq	word
Ilan	Iran, Persian	word
Inli	England, English	word
Intonesija	Indonesia, Indonesian	word
Isale	Israel	word
Isilan	Iceland, Icelandic	word
Italija	Italy, Italian	word
Jamanija	Yemen	word
Kalalinuna	Greenland, Greenlandic	word
Kana	Ghana	word
Kanata	Canada	word
Kanse	France, French	word
Katala	Qatar	word
Katelo	Georgia, Georgian	word
Katemala	Guatemala	word
Kenata	Grenada	word
Kepeka	Quebec	word
Keposi	Cyprus	word
Kilipasi	Kiribati	word
Kinla	Wales, Welsh	word
Konko (pi ma tomo Kinsasa)	Congo, Dem. Rep.	phrase
Konko (pi ma tomo Pasawi)	Congo, P. Rep.	phrase
Kosalika	Costa Rica	word
Kosiwa	Cфte d'Ivoire	word
Kupa	Cuba	word
Kusala	Gujarat, Gujarati	word
Kuwasi	Kuweit	word
Lanka	Sri Lanka	word
Lesi	Brittany, Breton	word
Lipija	Libya	word
Lisensan	Liechtenstein	word
Lomani	Romania, Romanian	word
Losi	Russia, Russian	word
Lowasi	Croatia, Croatian	word
Lowenki	Slovakia, Slovak	word
Lowensina	Slovenia, Slovenian	word
Lunpan	Lebanon	word
Lusepu	Luxemburg	word
Luwanta	Rwanda	word
Maketonija	Macedonia	word
Malakasi	Madagascar, Malagasy	word
Malasija	Malaysia, Malay	word
Malawi	Malawi	word
Mali	Mali	word
Malipe	Morocco	word
Masija	Hungary, Hungarian	word
Masu	Egypt	word
Mesiko	Mexico	word
Mewika	USA, American	word
Mijama	Myanmar	word
Motowa	Moldova	word
Mulitanija	Mauritania	word
Namipija	Namibia	word
Naselija	Nigeria	word
Netelan	Netherlands, Dutch	word
Nijon	Japan, Japanese	word
Nise	Niger	word
Nosiki	Norway, Norwegian Bokmеl	word
Nusilan	New Zealand	word
Ontula	Honduras	word
Osalasi	Austria	word
Oselija	Australia	word
Pakisan	Pakistan	word
Palakawi	Paraguay	word
Palani	Bahrein	word
Palata	India	word
Panama	Panama	word
Panla	Bangladesh, Bengali	word
Papeto	Barbados	word
Papuwanijukini	Papua New Guinea	word
Pasila	Brasil	word
Pawama	Bahamas	word
Pelalusi	Belarus, Belarussian	word
Pelu	Peru	word
Pemuta	Bermuda	word
Penesuwela	Venezuela	word
Penin	Benin	word
Pesije	Belgium	word
Pilipina	Philipines, Tagalog	word
Pilisin	Palestine	word
Pisi	Fiji	word
Piten	Britain, UK	word
Pokasi	Bulgaria, Bulgarian	word
Posan	Bosnia and Herzegovina, Bosnian	word
Posuka	Poland, Polish	word
Potuke	Portugal, Portugese	word
Samalino	San Marino	word
Sameka	Jamaica, Jamaican Patoi	word
Samowa	Samoa	word
Sasali	Algeria	word
Sawa	Java, Javanese	word
Sawasi	Swaziland	word
Seki	Czech (Republic)	word
Seneka	Senegal	word
Setapika	South Africa	word
Sile	Chile	word
Sinita	Trinidad and Tobago	word
Sipusi	Djibouti	word
Sonko	China, Chinese	word
Sopisi	Serbia, Serbian	word
Sukosi	Scotland, Scots	word
Sulija	Syria	word
Sumi	Finland, Finnish	word
Sutan	Sudan	word
Suwasi	Switzerland, Swiss	word
Tansi	Denmark, Danish	word
Tawi	Thailand, Thai	word
Toko	Togo	word
Tominika	Dominican Republic	word
Tona	Tonga, Tongan	word
Tosi	Germany, German	word
Tuki	Turkey, Turkish	word
Tunisi	Tunisia	word
Tuwalu	Tuvalu	word
Ukanta	Uganda	word
Ukawina	Ukraine, Ukrainian	word
Ulukawi	Uruguay	word
Uman	Oman	word
Utun	Jordan	word
Wanuwatu	Vanuatu	word
Wasikano	Vatican	word
Wensa	Sweden, Swedish	word
a	ahh, ha!, umm, hmm, ooh, etc.	word
akesi	reptile, amphibian	word
ala	zero	word
ala li jaki.	Nothing is dirty.	phrase
ali / (ale)	(noun) everything, anything, life, the universe   (adjective) all, every, complete, whole	phrase
anpa	ground; low, deep; to lower, to defeat	word
ante	other, different	word
anu	or	word
awen	to wait, to pause, to stay; remaining	word
e	introduces direct object	word
en	and	word
ijo	something, anything, stuff, thing	word
ike	bad, evil, complicated	word
ilo	tool, device, machine	word
insa	inside, stomach	word
jaki	dirty, nasty, trash	word
jan	somebody, anybody, person, etc.	word
jan Eta li jan unpa.	Heather is a whore.	phrase
jan Kanata	Canadian person	phrase
jan Keli o, sina pona lukin.	Kelly, you are pretty.	phrase
jan Ken o, pipi li lon len sina.	Ken, a bug is on your shirt.	phrase
jan Lisa li pona.	Lisa is cool.	phrase
jan Mawen o, sina wile ala wile moku?	Marvin, are you hungry?	phrase
jan Mesiko	Mexican person	phrase
jan Mewi li toki tawa mi.	Mary's talking to me.	phrase
jan Nesan li musi.	Nathan is funny.	phrase
jan Pentan li pana e sona tawa mi.	Brandon teaches to me.	phrase
jan Tepani o, sina ike tawa mi.	Steffany, I don't like you.	phrase
jan seme li moku?	Who is eating?	phrase
jan seme li tawa poka sina?	Who went with you?	phrase
jelo	yellow, light green	word
jo	to have, ownership, possession	word
kala	fish, seafood	word
kalama	sound, noise; to make noise,   to play an instrument	word
kalama musi 'Jingle Bells' li pona tawa mi.	I like the song 'Jingle Bells'.	phrase
kalama musi li pona tawa mi.	I like music.	phrase
kalama musi pi jan Elton-John li nasa.	The music of Elton John is odd.	phrase
kalama ni li seme?	What was that noise?	phrase
kama	to come, to happen, to cause	word
kasi	plant	word
kasi anpa	grass	phrase
kasi kule	flower	phrase
kasi lili	little weeds	phrase
kasi suli	trees, big shrubs	phrase
ken	can, to be able to; possibility	word
ken la ilo li pakala.	Maybe the tool is broken.	phrase
ken la jan Lisa li jo e ona.	Maybe Lisa has it.	phrase
ken la mi ken tawa ma Elopa.	Maybe I can go to Europe.	phrase
ken la ona li lape.	Maybe he's alseep.	phrase
kepeken	to use, with, using	word
kili	vegetable, fruit	word
kin	indeed, still, too	word
kiwen	stone, rock, hard like a rock	word
ko	semi-solid substance (glue, powder, etc.)	word
kon	air, atmosphere, spirit, wind	word
kule	colour	word
kulupu	group, community, society	word
kute	to hear	word
la	separates adverb of context from sentence	word
lape	to sleep; sleep	word
laso	blue, blue-green	word
lawa	main, leading, head; to lead	word
len	clothes, article of clothing, cloth, fabric	word
lete	cold; to freeze	word
lete li lon.	It's cold.	phrase
lete lili li lon.	It's cool.	phrase
lete mute li lon.	It's very cold.	phrase
letter	pronounced as in	word
li	separates a 3rd person subject   from its verb	word
lili	small, short, thin, young	word
linja	line, hair	word
lipu	paper, sheet, page, ticket, etc.	word
loje	red	word
luka	hand, arm	word
lukin	aware, attentive	word
lupa	hole, orifice, door, window	word
ma	Ecology	word
ma Italija li pona lukin.	Italy is beautiful.	phrase
ma Kanata li pona.	Canada is good.	phrase
ma tomo Alenta	Atlanta	phrase
ma tomo Lantan li suli.	London is big.	phrase
ma tomo Loma	Rome (Italy)	phrase
ma tomo Pelin	Berlin (Germany)	phrase
mama	parent	word
mani	money, currency	word
meli	woman, wife, girlfriend, female	word
meli Italija	Italian woman	phrase
mi	I, we, me, our	word
mi jan Pepe.	I am Pepe.	phrase
mije	man, husband, boyfriend, male	word
mije Epanja	Spanish man	phrase
moku	food, meal, to eat, to drink	word
moli	death; to die, to kill	word
monsi	rear, back, behind	word
mu	woof, meow, moo, any animal sound	word
mun	moon, lunar	word
musi	to have fun, to amuse; game, fun	word
mute	many, a lot	word
nanpa	number	word
nasa	crazy, foolish	word
nasin	road, way, doctrine, method	word
nena	bump, hill, extrusion	word
nimi	name, word	word
nimi mi li Pepe.	My name is Pepe.	phrase
noka	leg, foot	word
o	used for vocative and imperative	word
o awen.	Wait.	phrase
o lukin e ni.	Watch this.	phrase
o pali!	Work!	phrase
o tawa ma tomo poka jan pona sina.	Go to the city with your friend.	phrase
oko	eye	word
olin	to love affectionately, as of a person	word
ona	he, she, it	word
open	to open, to begin, to turn on	word
pakala	mess up, destroy, accident	word
pali	to do, to make, to work; activity, work	word
palisa	rod, stick, pointy thing	word
pana	to give, to send, to release, to emit	word
pi	essentially means 'of' (seperator)	word
pilin	to feel, touch	word
pimeja	black, dark	word
pini	end; to end, to stop, to turn off	word
pipi	any type of bug	word
poka	side, hip, nearby	word
poka telo	water side, the beach	phrase
poki	glass, cup, bottle, bowl, container	word
sama	same, similar	word
sama li ike.	Equality is bad.	phrase
seli	warm, hot, to burn	word
seli li lon.	It's hot.	phrase
seli lili li lon.	It's warm.	phrase
seli mute li lon.	It's very hot.	phrase
selo	skin, external surface of something	word
seme	what, which (used to make question words)	word
seme li lon poka mi?	What is beside me?	phrase
seme li lon tomo mi?	What is in my house?	phrase
seme li moku e kili mi?	What is eating my fruit?	phrase
seme li pona tawa sina?	What do you like?	phrase
seme li utala e sina?	What attacked you?	phrase
sewi	high, above, roof, top, sky	word
sijelo	body	word
sike	circle, ball	word
sin	new, another, more	word
sina	you, your	word
sinpin	wall, chest	word
sitelen	picture, image, to draw, to write	word
sitelen ma	map	phrase
sitelen tawa	movie, TV show	phrase
sitelen tawa 'Bowling for Columbine' li kin pona.	The movie 'Bowling for Columbine' is also good.	phrase
sitelen tawa 'Fahrenheit 9/11' li pona tawa mi.	I like the movie 'Fahrenheit 9/11'.	phrase
sona	to know, to know how to; wisdom	word
soweli	meat from a mammal, e.g. beef, pork	word
soweli ni li pona moku.	This cow is good to eat.	phrase
suli	big, tall, fat	word
suno	sun, light	word
supa	any type of furniture	word
supa lape	bed	phrase
suwi	sweet, cute; candy, cookie	word
tan	reason, cause; because of, from	word
taso	but, only	word
tawa	to go to, to move, to, for	word
telo	water, beverage, liquid, sauce	word
tenpo	time	word
tenpo kama la mi lape.	In the future, I'll sleep.	phrase
tenpo ni la mi lon.	At this time, I am here.	phrase
tenpo pimeja pini la mi kama nasa.	Last night, I became drunk.	phrase
tenpo pini la mi weka.	In the past, I was away.	phrase
tenpo tu tu la mi sike e suno.	Four times (la) I circled the sun.	phrase
toki	language; hey!	word
toki Epelanto	Esperanto	phrase
toki Inli li pona.	The English language is good.	phrase
toki Kanse	French language	phrase
tomo	buildings	word
tu	two; to divide	word
unpa	sex, to have sex, to fuck	word
uta	mouth	word
utala	war, battle, to fight	word
walo	white, light	word
wan	one; to unite	word
waso	chicken, poultry	word
wawa	strong, intense; energy, power	word
weka	away; to remove, to eliminate	word
wile	to want, desire, would like, hope	word
a a a!	ha ha ha!	phrase
a! telo sijelo loje li kama tan nena kute mi!	Ahh! Blood is coming from my ear!	phrase
a.	Ooh, ahh, unh, oh, etc.	word
akesi pi telo moli	venomous snakes, poisonous frogs	phrase
akesi li pana e telo moli.	The snake emitted venom ('deadly fluid').	phrase
ale / ali	everything, all	phrase
ale li jo e tenpo.	There is a time for everything. Everything in its right context.	phrase
ale li pona	all is well, I feel calm, I am at peace	phrase
ale li pona.	All is good. Life is beautiful. Everything will be OK.	phrase
ali	everything, all	word
anpa lawa	neck, throat	phrase
anpa pi sinpin lawa	chin	phrase
ante li kama.	Change comes. Times change.	phrase
awen pona	patient	phrase
ijo lon tomo	household things	phrase
ijo uta walo	teeth	phrase
ike li kama.	Bad comes. Shit happens.	phrase
ike lukin	ugly	phrase
ike!	Oh no!, Uh oh!, Alas!, etc.	word
ilo lape	sleeping pill	phrase
ilo lape soweli	animal tranquilizer or anesthetic, e.g. ketamine	phrase
ilo li pakala.	The tool is broken.	phrase
ilo moku	utensil, fork, spoon, knife, etc.	phrase
ilo musi	toy, thing used for entertainment	phrase
ilo nanpa	computer	phrase
ilo nasa	drugs	phrase
ilo nasa wawa	energy-giving drug, e.g. amphetamine	phrase
ilo ni li pilin lete.	This axe feels cold.	phrase
ilo pi sitelen tawa	tv	phrase
ilo pi sitelen toki	pen, pencil	phrase
ilo sona	smart tool or machine, e.g. computer	phrase
ilo suno	lamp	phrase
ilo toki	communications device, e.g. telephone, online chat	phrase
ilo unpa	sex toy	phrase
ilo wan ma	Internet	phrase
jan (pi pali) moku	chef, cook	phrase
jan (pi pali) unpa	sex worker, prostitute	phrase
jan Ana o pana e moku tawa mi.	Ana, give me food.	phrase
jan Epi o a!	Oh Abbie!	phrase
jan Ken o, mi olin e sina.	Ken, I love you.	phrase
jan Lisa taso li kama.	Only Lisa came.	phrase
jan Mose o lawa e mi mute tawa ma pona.	Moses, lead us to the good land.	phrase
jan Pawe o, mi wile ala moli.	Forrest, I don't want to die.	phrase
jan San o tawa tomo sina!	John, go to your house!	phrase
jan San o, ...	John, ...	phrase
jan San li seme?	Who is John?	phrase
jan Santa	Santa Claus	phrase
jan Sesi o moku e kili ni.	Jessie, eat this fruit.	phrase
jan Susan anu jan Lisa li moku e suwi?	Susan or Lisa ate the cookies?	phrase
jan Ta o toki ala tawa mi.	Todd, don't talk to me.	phrase
jan Wasintan [Washington] li jan lawa pona pi ma Mewika.	Washington was a good leader of America.	phrase
jan ala li toki.	Nobody is talking.	phrase
jan ali li wile tawa.	Everybody wants to travel.	phrase
jan kala	mermaid.	phrase
jan mute mute mute li kama!	Many, many, many people are coming!	phrase
jan pi ike lukin	an ugly person	phrase
jan pi ma tomo	person of the city, a city-dweller	phrase
jan pi nanpa tu tu	4th person	phrase
jan pi nasin sewi Kolisu	person of Christian religion, a Christian	phrase
jan pi pona lukin	an attractive person	phrase
jan pi wawa ala	a weak person	phrase
jan poka	neighbor, someone who is beside you	phrase
jan sin li kama.	More people are coming.	phrase
jan ike	enemy	phrase
jan kulupu	member of a group	phrase
jan lawa	leader, boss, master, chairperson, president, director	phrase
jan lawa pi jan utala	leader of soldiers (commander, general)	phrase
jan lawa pi tomo tawa kon	leader of airplanes, a pilot	phrase
jan lawa ma	president of country, governor of state, premier of province	phrase
jan lawa pi ma tomo	mayor	phrase
jan li moli e waso.	The person killed the bird.	phrase
jan li lon insa tomo.	Somebody's inside the house.	phrase
jan li moku.	Somebody is eating.	phrase
jan li moli	murder	phrase
jan li seme	personal traits	phrase
jan li suli mute. mani li suli lili.	People are more important than money.	phrase
jan li toki kepeken toki pona lon tomo toki.	People talk in/using Toki Pona in the chat room.	phrase
jan li wile jo e ma.	People want to own land.	phrase
jan lili	small, short, thin or young person, child	phrase
jan lili en jan suli li toki.	The child and the adult are talking.	phrase
jan lili pi jan Ken en jan Lisa li suwi.	Ken and Lisa's baby is sweet.	phrase
jan lili tu wan	3 children	phrase
jan lili li ken ala moku e telo nasa.	Children can't drink beer.	phrase
jan lili li sona ala e ike.	Children are innocent.	phrase
jan lili li wile e telo kili.	Children want fruit juice.	phrase
jan lili sina li suwi.	Your baby is cute.	phrase
jan luka tu	7 people	phrase
jan moli	dead man	phrase
jan nasa	strange, foolish, unconventional or crazy person	phrase
jan nasa utala	fighting fool	phrase
jan ni li sama mi.	That person is like me.	phrase
jan ni li pona lukin	That person is pretty.	phrase
jan olin	significant other, partner	phrase
jan pakala	an injured person, victim, etc.	phrase
jan pali	worker, employee	phrase
jan pi jan unpa mute	promiscuous person	phrase
jan pi kama sona	student	phrase
jan pi ma ante	foreigner	phrase
jan pi ma sama	fellow citizen of same country or land	phrase
jan pi musi sijelo	athlete	phrase
jan pi pana sona	teacher	phrase
jan pi pona pilin	good psychotherapist	phrase
jan pi pona sijelo	good doctor, healer	phrase
jan pi tomo pali	office worker, etc.	phrase
jan pi tomo sama	housemate, roommate	phrase
jan pona	good person, friend, positive person	phrase
jan sama	sister, brother, sibling	phrase
jan seme li meli sina?	Who is your girlfriend/wife?	phrase
jan sewi	God	phrase
jan sona	knowledgeable person, wise person, educated person, academic, specialist	phrase
jan sona li jan nasa.	A wise man is a fool. A genius thinks unconventionally.	phrase
jan sona nanpa	mathematician	phrase
jan sona pilin	psychologist	phrase
jan sona sijelo	doctor, physician	phrase
jan suli	big, tall or fat person, adult	phrase
jan toki	speaker, messenger, person communicating	phrase
jan unpa	sexual partner	phrase
jan utala	soldier	phrase
jan utala ali li nasa.	All soldiers are stupid.	phrase
jan utala ali li nasa	All soldiers are stupid.	phrase
jan utala li seli ala seli e tomo?	Is the warrior burning the house?	phrase
jan utala nasa	stupid soldier	phrase
jan utala nasa mute	many stupid soldiers	phrase
jan utala nasa ni	this stupid soldier	phrase
jan utala pi ma Mewika li ike tawa ma ali.	Soldiers of the USA are bad for the world.	phrase
jan wawa	strong person	phrase
jo ala e selo lon pini palisa	circumcised, cut	phrase
jo e linja mute	to be hairy	phrase
jo e mani mute	to be rich	phrase
jo e pilin pona	to have positive feelings, be mentally healthy	phrase
jo e selo lon pini palisa	uncircumcised, uncut	phrase
jo e sijelo pona	to be (physically) healthy	phrase
jo ijo li ike e jan.	Possession corrupts.	phrase
kala lete	raw fish, sushi	phrase
kalama ala li lon	No sound exists.	phrase
kalama musi en meli li pona tawa mi.	I like music and girls.	phrase
kama jo	get	phrase
kama jo e lupa meli	to get genital reconstruction surgery as a women, i.e. vaginoplasty	phrase
kama jo e palisa mije	to get genital reconstruction surgery as a man, i.e. metoidioplasty, phalloplasty	phrase
kama jo e sinpin lawa meli	to get facial feminization surgery	phrase
kama jo e sinpin mije	to get male chest reconstruction surgery	phrase
kama olin	fall in love with	phrase
kama pona!	Come well! Welcome!	phrase
kasi nasa / kasi sona	hemp	phrase
kasi nasa	intoxicating plant, e.g. marijuana	phrase
kasi pi tenpo pona Kolisu	Chrismas tree	phrase
kasi sona	intoxicating plant used in meditation, e.g. marijuana	phrase
kasi wawa	spice	phrase
ken la jan lili li wile moku e telo.	Maybe the baby is thirsty.	phrase
kepeken e kasi nasa	to smoke pot	phrase
kepeken e utala	to use violence	phrase
kepeken ike e ilo nasa	to abuse drugs	phrase
kepeken lili e ilo nasa	to use drugs in moderation	phrase
kili pi jan Susan	Susan's fruit	phrase
kili li lon poki.	The fruit is in the basket.	phrase
kili li pona tawa mi.	I like fruit.	phrase
kili li tawa anpa poka kasi.	The appel drops not far from the tree.	phrase
kili lili	small vegetable, fruit, e.g. berry, olive	phrase
kili lili kiwen	nut	phrase
kili loje	reddish fruit or vegetable, e.g. tomato	phrase
kili ma	earth vegetable, e.g. potato	phrase
kili mi	my fruit	phrase
kili palisa	long fruit or vegetable, e.g. carrot, banana, cucumber	phrase
kili pi jan Linta li ike.	Linda's fruit is bad.	phrase
kili suwi	(sweet) fruit	phrase
ko (walo) wawa	cocaine	phrase
ko jaki	shit, feces, pooh	phrase
ko jaki lon nena sinpin	boogers	phrase
ko lete li kama	it's snowing	phrase
kon en sewi	weather	phrase
kon sewi li jo e walo	it's cloudy	phrase
kon telo walo	snow, fog	phrase
kule lon palisa luka	nail polish	phrase
kulupu pi toki pona	the Toki Pona community	phrase
kulupu mama	family	phrase
kulupu pi tenpo mun	Month	phrase
kulupu pi tenpo suno luka tu	days of the week	phrase
lape li pona.	Sleep and rest are good.	phrase
lape pona!	Sleep well! Have a good night!	phrase
laso jelo / jelo laso	yellowish blue (green)	phrase
laso jelo	green (yellowish blue)	phrase
laso loje / loje laso	reddish blue (purple	phrase
laso loje	purple (reddish blue)	phrase
laso pimeja	dark blue	phrase
lawa e pilin	to master one's feelings, be composed	phrase
len jan	somebody's clothes	phrase
len pi jan Lisa	Lisa's clothes	phrase
len pi loje en laso	shirt of red and blue	phrase
len lawa	hat, hood, bonnet, headdress	phrase
len li lon poka mi.	The clothes are at my side.	phrase
len luka	gloves, mittens	phrase
len ni li kule seme?	What colour is this article of clothing?	phrase
len noka	shoe, pants	phrase
len pi jan Susan li jaki.	Susan's clothes are dirty.	phrase
len sina li telo ala telo?	Are your clothes wet?	phrase
lete li lon	it's cold	phrase
lete lili li kin lon.	Here is it little cold too.	phrase
linja (lawa)	hair	phrase
linja lawa	hair (of head)	phrase
linja lili oko	eyebrows, eyelashes	phrase
linja sinpin	beard, facial hair	phrase
linja uta	moustache	phrase
lipu toki	paper with written information, document, text, book	phrase
loje jelo	orange (yellowish red)	phrase
loje laso (pimeja)	(dark) blueish red, purple	phrase
loje walo	pink (whitish red)	phrase
lon tenpo pi pali ala	to be taking a sabbatical, break from work	phrase
luka luka	5 + 5 = 10	phrase
luka luka luka	5 + 5 + 5 = 15	phrase
luka luka tu	5 + 5 + 2 = 12	phrase
luka luka tu tu	5 + 5 + 2 + 2 = 14	phrase
luka luka tu wan	5 + 5 + 2 + 1 = 13	phrase
luka luka wan	5 + 5 + 1 = 11	phrase
luka mi li jaki. mi wile telo e ona.	My hands are dirty. I want to wash them.	phrase
luka tu	5 + 2 = 7	phrase
luka tu tu	5 + 2 + 2 = 9	phrase
luka tu wan	5 + 2 + 1 = 8	phrase
luka wan	5 + 1 = 6	phrase
lukin e toki	read	phrase
lukin jo e pali	to be looking for a job	phrase
lupa (meli)	vagina, pussy	phrase
lupa (tomo)	window, door	phrase
lupa jaki	anus	phrase
lupa kute	ear	phrase
lupa meli	vagina	phrase
lupa meli li mama ale.	A woman's womb is the mother of all things.	phrase
lupa monsi	anus	phrase
lupa nena	nostrils	phrase
lupa pi telo jelo	urethra	phrase
ma Amelika	the Americas	phrase
ma Amelika lete	North America	phrase
ma Amelika seli	South America	phrase
ma Antasika	Antarctica	phrase
ma Apika	Africa	phrase
ma Asija	Asia	phrase
ma Elopa	Europe	phrase
ma Elopa li weka tan ma Mewika.	Europe is away from the USA.	phrase
ma Inli li pona.	England is good.	phrase
ma Mewika li weka ala tan ma Kupa.	The USA is not away from Cuba.	phrase
ma ali li pona.	All nations are good.	phrase
ma kasi	forest, jungle	phrase
ma pi jan Keli	Keli's country	phrase
ma seme li pona tawa sina?	Which countries do you like?	phrase
ma sina	your country	phrase
ma li pona lukin.	The countryside is good to look at.	phrase
ma lon telo	Island	phrase
ma mi li pimeja.	My land is dark.	phrase
ma ona	her country	phrase
ma telo	mud, swamp	phrase
ma tomo	town	phrase
ma tomo Akajela	Cairo (Egypt)	phrase
ma tomo Alana	Atlanta (USA)	phrase
ma tomo Alawa	Ottawa (Canada)	phrase
ma tomo Alipasi	Halifax (Canada)	phrase
ma tomo Anpu	Hamburg (Germany)	phrase
ma tomo Ansetan	Amsterdam (Netherlands)	phrase
ma tomo Asina	Athens (Greece)	phrase
ma tomo Ele	Los Angeles (USA)	phrase
ma tomo Esupo	Espoo (Finland)	phrase
ma tomo Iwesun	Hilversum (Netherlands)	phrase
ma tomo Kakawi	Calgary (Canada)	phrase
ma tomo Kenpisi	Cambridge (USA, GB)	phrase
ma tomo Kunte	Bangkok (Thailand)	phrase
ma tomo Lanten	London (England)	phrase
ma tomo Lesinki	Helsinki (Finland)	phrase
ma tomo Manten	Moncton (Canada)	phrase
ma tomo Mesiko	Mexico City (Mexico)	phrase
ma tomo Milano	Milan (Italy)	phrase
ma tomo Minsen	Munich (Germany)	phrase
ma tomo Monkela	Montreal (Canada)	phrase
ma tomo Napoli	Naples (Italy)	phrase
ma tomo Nujoka	New York City (USA)	phrase
ma tomo Osaka	Osaka (Japan)	phrase
ma tomo Paki	Paris (France)	phrase
ma tomo Pasen	Boston (USA)	phrase
ma tomo Peminan	Birmingham (England)	phrase
ma tomo Pesin	Beijing, Peking (China)	phrase
ma tomo Pilense	Florence (Italy)	phrase
ma tomo Polan	Portland (USA)	phrase
ma tomo Putapesi	Budapest (Hungary)	phrase
ma tomo Sakata	Jakarta (Indonesia)	phrase
ma tomo Sanpansiko	San Francisco (USA)	phrase
ma tomo Sawi	Sackville (Canada)	phrase
ma tomo Sene	Geneva (Switzerland)	phrase
ma tomo Sensan	St. John's (Canada)	phrase
ma tomo Sesija	Shediac (Canada)	phrase
ma tomo Sije	Dieppe (Canada)	phrase
ma tomo Solu	Seoul (South Korea)	phrase
ma tomo Tanpele	Tampere (Finland)	phrase
ma tomo Telawi	Tel Aviv (Israel)	phrase
ma tomo Tokijo	Tokyo (Japan)	phrase
ma tomo Towano	Toronto (Canada)	phrase
ma tomo Tuku	Turku (Finland)	phrase
ma tomo Wankuwa	Vancouver (Canada)	phrase
ma tomo Wenesija	Venice (Italy)	phrase
ma tomo lawa	capital	phrase
mama meli	mother	phrase
mama mije	father	phrase
mama mama	grandparent	phrase
mama mi li moli la mi pilin ike.	My parents die, I feel bad.	phrase
mama ona li kepeken e kasi nasa.	His mother used pot.	phrase
meli (insa)	person who identifies as female, e.g. male-to-female transsexual person	phrase
meli (olin)	wife, girlfriend	phrase
meli en mije	Gender	phrase
meli li lon sewi mije	woman on top	phrase
meli li nasa e mije.	Women will drive men crazy.	phrase
meli lili	daughter	phrase
meli mi pi nanpa wan li nasa.	My first girlfriend was crazy.	phrase
meli mije	masculine girl, butch, tomboy	phrase
meli sama	sister	phrase
meli unpa	female sexual partner	phrase
mi anpa e jan utala.	I defeated the warrior.	phrase
mi en sina li jan pona.	You and I are friends.	phrase
mi kalama kepeken ilo.	I make noise using an instrument.	phrase
mi kama e pakala.	I caused an accident.	phrase
mi kama jo e telo.	I got the water.	phrase
mi kepeken e ilo.	I'm using tools.	phrase
mi kepeken e poki ni.	I'm using that cup.	phrase
mi kule e lipu	I'm coloring the paper.	phrase
mi lon e sina.	I made you aware of reality.    I forced you to be to present and alert.	phrase
mi lon tomo.	I'm in the house.	phrase
mi olin e sina.	I love you.	phrase
mi pilin e ni: sina ike.	I think this: You're bad.	phrase
mi pilin ijo.	I'm thinking (about) something.	phrase
mi pilin ike.	I feel bad. / I feel sad.	phrase
mi pilin pi meli ni.	I'm thinking about that woman.	phrase
mi pilin pona.	I feel good. / I feel happy.	phrase
mi tawa e kiwen.	I'm moving the rock.	phrase
mi tawa tomo mi.	I'm going to my house.	phrase
mi weka.	I was away.	phrase
mi wile e ni: mi lon tomo.	I want this: I'm at home.	phrase
mi wile lon tomo.	I want to be at home. / I want in a house.	phrase
mi wile lukin e ma.	I want to see the countryside.	phrase
mi wile pakala e sina.	I must destroy you.	phrase
mi en meli mi li wan.	My girlfriend and I got married.	phrase
mi jan li suli.	I am somebody and am important.	phrase
mi jo e kili.	I have a fruit.	phrase
mi kama tan ma Mewika.	I come from America.	phrase
mi kama tan ma tomo Pelin.	I'm from Berlin.	phrase
mi ken ala ken pilin e monsi sina?	may I touch your butt?	phrase
mi kepeken e poki e ilo moku.	I'm using a bowl and a spoon.	phrase
mi kin olin e sina.	I still love you. / I love you too.	phrase
mi kute e kalama musi.	I'm listening to music.	phrase
mi kute e toki sina.	I hear your talking.	phrase
mi lape ala.	I'm not sleeping.	phrase
mi lape la ali li pona.	When I'm asleep, everything is good.	phrase
mi lape. mi sona.	I sleep. I know.	phrase
mi lawa pona e jan.	I lead people well.	phrase
mi lon ma kasi.	I'm in the forest.	phrase
mi lon tan seme?	Why am I here?	phrase
mi lukin kepeken ilo suno.	I look using a flashlight.	phrase
mi lukin taso e meli ni! ali li pona.	I only looked at that girl! Everything's okay.	phrase
mi lukin e ma. ni li pona tawa mi.	I'm watching the countryside. This is good to me.	phrase
mi lukin e ni.	I am looking at that.	phrase
mi lukin e soweli luka.	I saw five mammals.	phrase
mi lukin sewi e tomo suli.	I am looking up at the big building.	phrase
mi moku e kili e telo.	I eat/drink fruit and water.	phrase
mi moku e kili.	I eat fruit.	phrase
mi moku kepeken ilo moku.	I eat using a fork/spoon/   any type of eating utensil.	phrase
mi moku li pakala.	I eat and destroy.	phrase
mi moku lon tomo.	I eat in the house.	phrase
mi moku poka jan pona mi.	I ate beside my friend.	phrase
mi moku tan ni: mi wile moku.	I eat because I'm hungry.	phrase
mi moku lili e kili lili.	I nibble (eat a little) the small fruit.	phrase
mi moku lon poka pi jan pona mi.	I ate at side of my friend.	phrase
mi moku mute. sina moku lili.	I eat more than you.	phrase
mi musi ala.	I'm not having fun. / I'm bored.	phrase
mi musi taso.	I'm just joking.	phrase
mi mute	we, us	phrase
mi mute li lukin lili e ona.	We barely saw it.	phrase
mi mute o musi.	Let's have fun.	phrase
mi mute o tawa.	Let's go.	phrase
mi olin e sina	I love you	phrase
mi pali taso.	I just work. (All I ever do is work.)	phrase
mi pali mute la mi pilin ike.	When I work a lot, I feel bad.	phrase
mi pana e ko jaki.	I crapped.	phrase
mi pana e sona pi toki pona tawa ona.	I teach her in toki pona.	phrase
mi pana e telo jelo.	I peed.	phrase
mi pilin e ni: ona li jo ala e mani.	I think that he doesn't have money.	phrase
mi pilin e seli sijelo sina.	I feel your bodily warmth.	phrase
mi pilin lete.	I'm cold.	phrase
mi pini e lape sina.	I ended your sleep.   I woke you up.	phrase
mi pona e ijo.	I'm fixing something.	phrase
mi pona e ale mi, la mi pona e mi.	When I improve all areas of my life, I am making myself good.	phrase
mi pona e tomo tawa jan pakala.	I fixed the house for the disabled man.	phrase
mi pona.	I am/was/will be good.	phrase
mi pona. taso meli mi li pakala.	I'm okay. But my girlfriend is injured.	phrase
mi sona ala e tan.	I don't know the reason. / I don't know why.	phrase
mi sona ala e nimi pi ona mute.	I don't know their names.	phrase
mi sona e ni taso.	I know only that. (That's all I know.)	phrase
mi suli mute. sina suli lili.	I'm bigger than you.	phrase
mi suli.	I'm important. / I'm fat.	phrase
mi tawa	I'm going. Bye!	phrase
mi tawa tomo toki. ona li pona tawa mi.	I go the chat room. It is good for me.	phrase
mi telo e mi lon tomo telo.	I bathe myself in the restroom.	phrase
mi toki tawa sina.	I talk to you.	phrase
mi toki jan.	I talked about people	phrase
mi toki pi jan ike.	I talked about bad people.	phrase
mi utala ike.	I fight badly.	phrase
mi wawa ala.	I'm not strong. / I'm weak.	phrase
mi weka e ijo tu ni.	I got rid of those two things.	phrase
mi weka e ike jan, la mi weka e ike mi.	When I forgive somebody's wrongdoings, I cleanse myself of negativity.	phrase
mi wile ala pali.	I'm lazy.	phrase
mi wile ala tawa musi.	I don't want to dance.	phrase
mi wile e moku e telo.	I want food and water.	phrase
mi wile ala e ijo. mi lukin taso.	I don't want anything. I'm just looking.	phrase
mi wile ala toki pi kalama musi.	I don't want to talk about music.	phrase
mi wile e suwi!	I want a cookie!	phrase
mi wile e suwi sin!	I want another/more cookie(s)!	phrase
mi wile kama sona e toki Inli.	I want to learn English.	phrase
mi wile lukin e ma e suno.	I want to see the land and the sun.	phrase
mi wile lukin e ma ante.	I want to see other countries.	phrase
mi wile lukin e tomo mi. taso mi lon ma ante.	I want to see my house. But I'm in a different country.	phrase
mi wile moku e waso.	I want to eat chicken.	phrase
mi wile moku e kili loje.	I want to eat a red fruit.	phrase
mi wile moku. taso mi jo ala e moku.	I want to eat. But I don't have food.	phrase
mi wile pali kepeken nimi 'lon'.	I need more exercises with 'lon'.	phrase
mi wile sin e telo pi lape ala.	I need more coffee.	phrase
mi wile tawa ma Tosi.	I want to go to Germany.	phrase
mi wile tawa weka.	I want to leave.	phrase
mi wile toki meli.	I want to talk about girls.	phrase
mi wile unpa e ona.	I want to have sex with him/her.	phrase
mi wile unpa e sina	I want to have sex with you	phrase
mije (insa)	person who identifies as male, e.g. female-to-male transsexual person	phrase
mije (olin)	husband, boyfriend	phrase
mije li lon sewi meli	missionary position	phrase
mije lili	son	phrase
mije meli	feminine guy	phrase
mije sama	brother	phrase
mije unpa	male sexual partner	phrase
mije wan la nimi wan. meli wanla nimi awen.	One man one word. One woman one dictionary.	phrase
mile moku e telo	to be thirsty	phrase
moku li pona.	The food is good.	phrase
moku e telo	to drink	phrase
moku e telo nasa	to drink alcohol	phrase
moku li lon insa mi.	Food is in my stomach.	phrase
moku lili	snack, small ingestible item	phrase
moku lili pi pilin pona mute	strong euphoric drug taken orally, e.g. MDMA	phrase
moku pona!	Good food! Enjoy your meal!	phrase
moku suwi	sweets, candy, chololate, etc.	phrase
moku telo	liquid food, e.g. soup	phrase
moku walo	whiteish food, e.g. rice	phrase
mun li pimeja (ale)	it's new moon	phrase
mun li pimeja e suno	solar eclipse	phrase
mun li sike (ale)	it's full moon	phrase
musi pona!	Good fun! Have fun!	phrase
nanpa pi ilo toki	phone number	phrase
nanpa pi ma tomo	zip code	phrase
nasa lukin	funny-looking	phrase
nasin pi toki pona	the ideology behind Toki Pona	phrase
nasin ale	The Way of Life	phrase
nasin ante li pona tawa jan ante.	Different ways are good for different people.	phrase
nasin li jo e telo kiwen	the roads are icy	phrase
nasin mani li ike.	Capitalism is negative.	phrase
nasin pona	Taoism, simple or good path	phrase
nasin pona Juju	Unitarian Universalism	phrase
nasin pona Lasapali	Rastafarianism	phrase
nasin pona Latapali	Rastafarianism	phrase
nasin pona li mute.	The good ways are many. There are many right ways of doing things.	phrase
nasin sewi	religions	phrase
nasin sewi Jawatu	Judaism	phrase
nasin sewi Kolisu	Christianity	phrase
nasin sewi Puta	Buddhism	phrase
nasin sewi Silami	Islam	phrase
nasin sewi ma	earth religion, e.g. Native American beliefs	phrase
nena (lawa)	nose	phrase
nena kon	nose	phrase
nena kute	ear	phrase
nena lili (unpa) meli	clitoris	phrase
nena lili pi nena mama	nipples	phrase
nena mama, nena meli	breasts	phrase
nena meli	breasts	phrase
nena sike meli	female breasts	phrase
nena suli li pana e ko seli	a volcano is erupting	phrase
ni li ike tawa mi	That is bad to me. / I don't like that.	phrase
ni li kule seme?	What color is that?	phrase
ni li pilin lete mute.	This is very cold.	phrase
ni li pilin seli lili.	This feels warm.	phrase
ni li pona tawa mi.	That is good to me. / I like that.	phrase
ni li jan lili ona pi nanpa tu.	This is her second child.	phrase
ni li jan seme?	Who is that?	phrase
nimi 'lon' li pona ala tawa mi.	'lon' is not easy for me.	phrase
nimi pi mi mute	our names	phrase
nimi kepeken @	email  ??	phrase
o kalama ala!	Don't make noise!	phrase
o tu e palisa ni.	Split this stick.	phrase
o weka e jan lili tan ni.	Remove the kid from here	phrase
o weka e len sina.	Remove your clothes.	phrase
o jo e sijelo pona	to your health	phrase
o moli e pipi kepeken palisa.	Kill the roach with the stick.	phrase
o olin e jan poka.	Love thy neighbour.	phrase
o pana e sitelen ma tawa mi.	Give me the map.	phrase
o pana e pona tawa ma.	Love the earth. Take care of our planet.	phrase
o pana e sike tawa mi.	Give the ball to me.	phrase
o pilin e nena.	Touch the button.	phrase
o sona ala. o pali.	Stop thinking. Do stuff.	phrase
o sona e sina!	Know thyself!	phrase
o tawa musi poka mi!	Dance with me!	phrase
o tu.	Break up. Split apart.	phrase
oko mi li lukin pona	my eyes see well	phrase
oko sina li pona lukin	you have beautiful eyes	phrase
olin e jan mute	to be polyamorous	phrase
olin e meli	to love women	phrase
olin e meli e mije	to love women and men	phrase
olin e mije	to love men	phrase
olin suli li awen.	Old love never rusts.	phrase
ona anu jan ante li ike?	Is he bad, or is it the   other person who's bad?	phrase
ona li kama tawa tomo mi.	He came to my house.	phrase
ona li lon ala lon tomo?	Is he in the house?	phrase
ona li lon sewi mi.	He is above me.	phrase
ona li tawa ala tawa ma ike?	Did he go to the evil land?	phrase
ona li tawa e len mi.	She moved my clothes.	phrase
ona li tawa sewi kiwen.	She's going up the rock.	phrase
ona li wile jo e ilo.	He would like to have a tool.	phrase
ona li jo e seme?	What does he have?	phrase
ona li kama tawa ma mi.	He's coming to my country.	phrase
ona li kule e tomo tawa.	He's painting the car.	phrase
ona li lawa e jan tawa ma pona.	He led people to the good land.	phrase
ona li lukin e pipi.	He's watching the bug.	phrase
ona li lukin sama pipi.	He looks like a bug.	phrase
ona li pona e ilo.	She's fixing the machine.	phrase
ona li pona li lili.	It is good and is small.	phrase
ona li wile mute e ni.	He wants that a lot.	phrase
ona li wile ala kute e ni.	He shouldn't hear this.	phrase
ona mute	they, them	phrase
ona mute li tawa utala	They're going to the war.	phrase
ona mute li nasa e jan suli.	They drove the adults crazy.	phrase
pali ala	not working	phrase
pali e ike tawa	to do bad things to, to show disrespect for	phrase
pali li ike tawa mi.	I'm lazy.	phrase
pali li pana e sona.	One learns by experience.	phrase
pali pona	Order	phrase
pali pona li lawa tawa lon.	Good work is most importand in live. / Order is the half of the live.	phrase
palisa (mije)	penis	phrase
palisa li lawa e mije.	A man's penis control him.	phrase
palisa lili noka	toes	phrase
palisa luka	finger	phrase
palisa mije	penis	phrase
palisa sina li kiwen	your cock is hard	phrase
palisa tawa	vibrating dildo	phrase
palisa uta	tongue	phrase
pana e ko jaki	to pooh, to shit	phrase
pana e kon (pi pilin) pona	to laugh	phrase
pana e moku tawa	to feed, nourish	phrase
pana e palisa lon lupa	to penetrate	phrase
pana e palisa uta lon	to lick	phrase
pana e pilin pona tawa	to send positivity to, make feel good	phrase
pana e sona	to teach (give knowledge)	phrase
pana e telo (walo) mije	to ejaculate	phrase
pana e telo jelo	to pee, to urinate	phrase
pana e telo oko	to cry, weep	phrase
pana e uta (tawa jan, lon ijo)	to kiss	phrase
pana e uta lon lupa (meli)	to perform cunnilingus	phrase
pana e uta lon palisa	to fellate	phrase
pana wawa	BDSM	phrase
pilin ala	indifferent, unfeeling	phrase
pilin e ike jan	to pity somebody, feel bad for somebody	phrase
pilin e moli jan	to mourn somebody	phrase
pilin e weka jan	to miss somebody	phrase
pilin ike	to feel bad, sad, depressed, unhappy, bitter, discontented, grumpy	phrase
pilin ike tan	be afraid of, sad because of, regret, be offended by	phrase
pilin ike tawa	to have negative feelings for, be upset at, angry at, hate, resent	phrase
pilin ike wawa	to have intense negative feelings, be pissed off, furious	phrase
pilin nasa	to feel silly, strange, weird, crazy, drunk, high	phrase
pilin pona	to feel good, happy, content, enjoy oneself, comfortable	phrase
pilin pona li pana e sijelo pona.	Positive feelings grant good health. Mind over matter.	phrase
pilin pona mute	to feel great, amazing, awesome	phrase
pilin pona tan	to feel good because of, to enjoy	phrase
pilin wawa (unpa)	orgasm	phrase
pilin wawa	to feel strong, energetic, excited, confident, proud	phrase
pimeja laso	blueish black	phrase
pimeja li lon	it is night	phrase
pini li pona la ale li pona.	Is the end good -- everything is good.	phrase
pini palisa	glans, head of the penis	phrase
pini pi nena mama	nipples	phrase
pini pi sike sune	sylvester	phrase
pipi li lukin li unpa.	The bug looks and has sex.	phrase
pipi li lon anpa mi.	The bug is underneath me.	phrase
pipi li moku ala moku e kili?	Are the bugs eating the fruit?	phrase
pipi li moli.	The bug is dead.	phrase
pipi li moku e kasi.	Bugs eat plants.	phrase
poka mi li pakala.	My hip hurts.	phrase
poki kon	lungs	phrase
poki lete	refrigerator	phrase
poki seli	oven, microwave	phrase
poki telo	sink, bathtub	phrase
pona e pilin jan	cheer up, make somebody happy	phrase
pona lukin	beautiful, pretty, handsome	phrase
pona moku	delicious, tasty	phrase
pona unpa	sexy, good in bed	phrase
pona!	Yay! Good! Hoorah!	word
seli suno	the sun's heat	phrase
seli li lon	it's warm or hot	phrase
seli suno li seli e tomo mi.	The sun's warmth heats my home.	phrase
selo lon pini palisa	foreskin	phrase
selo mi li wile e ni: mi pilin e ona.	My skin wants this: I touch it.	phrase
sewi monsi	upper back, shoulders	phrase
sewi pi sinpin lawa	forehead	phrase
sike mama waso	egg	phrase
sike mije (tu)	testicles, balls	phrase
sike mije	man's testicles	phrase
sike suno wan	one year	phrase
sin en ante li sin e lawa li pana e sona.	Novelty and change freshen the mind and bring insight.	phrase
sina kama e ni: mi wile moku.	You caused this: I want to eat.   You made me hungry.	phrase
sina ken ala ken lape?	Can you sleep?	phrase
sina lukin ala lukin e kiwen?	Do you see the rock?  lukin  Yes  lukin ala  No	phrase
sina pana ala pana e moku tawa jan lili?	Did you give food to the child?	phrase
sina pilin e seme?	What are you thinking?	phrase
sina pilin seme?	how are you? how are you feeling?	phrase
sina pona ala pona?	Are you okay?	phrase
sina sona ala sona e toki mi?	Do you understand what I'm saying?  sona  Yes  sona ala  No	phrase
sina wile ala wile moku?	Do you want to eat?  wile  Yes  wile ala  No	phrase
sina jo e kili anu telo nasa?	Do you have the fruit,   or is it the wine that you have?	phrase
sina kama anu seme?	Are you coming or what?	phrase
sina kama tan seme?	Why did you come?	phrase
sina kama jo e jan pona lon ni.	You will get friends there.	phrase
sina kama tan ma seme?	Which country do you come from?	phrase
sina ken ala ken kama?	Can you come?	phrase
sina kepeken ala kepeken e ni?	Are you using that?	phrase
sina lon seme?	Where are you?	phrase
sina lon ala lon ma tomo Wankuwa?	Do you live in Vancouver?	phrase
sina lon ma tomo seme?	What city do you live in?	phrase
sina lukin sewi e suno.	You look up at the sun.	phrase
sina lukin e jan seme?	Whom did you see?	phrase
sina lukin e seme?	What are you watching?	phrase
sina lukin e pipi.	You're watching a bug.	phrase
sina moku e telo nasa la sina nasa.	If you drink beer, you'll be silly.	phrase
sina moli la sina ken ala toki.	If you are dead, you can't speak.	phrase
sina pakala e seme?	What did you hurt?	phrase
sina pakala e ilo kepeken nasin seme?	How did you break the tool?	phrase
sina pali e ni kepeken nasin seme?	How did you make this?	phrase
sina pana e ike, la sina kama jo e ike.	If you give evil, you will receive evil.	phrase
sina pona.	You are good. / You fix.	phrase
sina sona e toki ni la sina sona e toki pona!	Figure this one out for yourself. :o)	phrase
sina tawa ma tomo tan seme?	Why did you go to the city?	phrase
sina toki e ni tawa mi: sina moku.	You told me that you are eating.	phrase
sina toki pi mama anu jan lili?	Are you talking about the parent,   or is the child that you're talking about?	phrase
sina toki tawa jan seme?	Whom are you talking to?	phrase
sina toki tawa mi anu ona?	Are you talking to me,   or are you talking to him?	phrase
sina toki tawa mi anu seme?	You ask _me_?	phrase
sina wile kepeken e ilo.	You have to use tools.	phrase
sina wile tawa telo suli.	You want to go to the ocean.	phrase
sina wile ala wile pali? wile ala.	Do you want to work? No.	phrase
sina wile e mani anu seme?	Do you want the money or what?	phrase
sina wile kama tawa tomo toki.	You should come to the chat room.	phrase
sina wile moku anu seme?	Do you want to eat or what?	phrase
sina wile tawa ma seme?	What place do you want to go to?	phrase
sina wile toki tawa mije anu meli?	Do you want to talk a male, or a female?	phrase
sinpin (lawa)	face	phrase
sitelen e toki	to write	phrase
sitelen pi ilo nanpa	computer screen	phrase
sitelen toki	writing	phrase
sitelen unpa	visual erotica, porn	phrase
sona e toki	to know, speak, understand a language	phrase
sona mute	smart, intelligent, wise	phrase
sona pona e toki	to master a language	phrase
soweli li kama moli.	The cheetah is dying.	phrase
soweli lili pi ilo nanpa	computer mouse	phrase
soweli mi li kama moli.	My dog is dying.	phrase
suno li suli.	The sun is big.	phrase
suno li lon sewi.	The sun is in the sky.	phrase
suno li suli ala suli?	Is the sun big?	phrase
suno li jelo.	The sun is yellow.	phrase
suno li lon	it's sunny	phrase
suno li lon poka pimeja.	Light is beside darkness. Opposites are interconnected. Yin and yang.	phrase
suno pona!	Good sun! Good day!	phrase
supa lawa	pillow	phrase
supa moku	dinner table	phrase
supa monsi	chair, couch	phrase
supa pali	work desk	phrase
suwi lukin	cute	phrase
tawa musi	dance (move entertainingly)	phrase
tawa pona!	(in reply) Go well! Good bye!	phrase
tawa pona.	Good bye (spoken by the person who's staying)	phrase
telo (loje) mun	menses	phrase
telo (walo) mije	sperm, come	phrase
telo ona	his/her/its water	phrase
telo e mi	to shower	phrase
telo jaki lon nena sinpin	snot	phrase
telo jelo	urine, pee	phrase
telo kili	juice	phrase
telo kili ni li suwi.	This fruit drink is sweet.	phrase
telo kiwen	ice	phrase
telo kiwen lili li kama	it's hailing	phrase
telo li kama	it's raining	phrase
telo lili li lon kon	it's humid	phrase
telo loje	blood	phrase
telo mama soweli	cow milk	phrase
telo nasa	intoxicating liquid, e.g. alcohol	phrase
telo nasa loje seli	mulled claret	phrase
telo nasa pi wawa ala	weak beer, US American beer	phrase
telo nasa wawa	vodka, whisky,	phrase
telo pi lape ala	coffee	phrase
telo seli	hot beverage, e.g. coffee	phrase
telo seli jelo	green tea	phrase
telo seli pimeja pi lape ala	coffee	phrase
telo seli wawa	coffee	phrase
telo sijelo loje	blood (red bodily fluid)	phrase
telo suli li ike tawa mi.	I don't like the ocean.	phrase
telo suli li laso.	The big water [ocean] is blue.	phrase
telo walo mije	The fluid that a man releases during unpa.	phrase
telo wawa	energy drink	phrase
tenpo ala	never	phrase
tenpo ale	always, all the time	phrase
tenpo ali la o kama sona!	Always learn!	phrase
tenpo kama	the future (coming time)	phrase
tenpo kama lili	soon (little coming time)	phrase
tenpo lete	winter	phrase
tenpo li sijelo e sijelo ike ale.	The time heals every wounds.	phrase
tenpo li tawa la sona li kama.	Time comes -- advice comes.	phrase
tenpo lili	soon, moment, briefly	phrase
tenpo lili la mi wile weka	I must leave soon	phrase
tenpo moku	mealtime	phrase
tenpo mun	month	phrase
tenpo mun pi nanpa luka	May	phrase
tenpo mun pi nanpa luka luka	October	phrase
tenpo mun pi nanpa luka luka tu	December	phrase
tenpo mun pi nanpa luka luka wan	November	phrase
tenpo mun pi nanpa luka tu	July	phrase
tenpo mun pi nanpa luka tu tu	September	phrase
tenpo mun pi nanpa luka tu wan	August	phrase
tenpo mun pi nanpa luka wan	June	phrase
tenpo mun pi nanpa tu	February	phrase
tenpo mun pi nanpa tu tu	April	phrase
tenpo mun pi nanpa tu wan	March	phrase
tenpo mun pi nanpa wan	January	phrase
tenpo mute	often, many times	phrase
tenpo ni	the present (this time)	phrase
tenpo pi mute seme la sina sike e suno?	How old are you?	phrase
tenpo pimeja	night	phrase
tenpo pimeja ni	tonight (this dark time)	phrase
tenpo pimeja pini	last night (past dark time)	phrase
tenpo pini	the past (past time)	phrase
tenpo pona Kolisu	Chrismas	phrase
tenpo seli	summer	phrase
tenpo seme la ona li kama lon tomo sina?	When is he coming to your house?	phrase
tenpo seme?	when?	phrase
tenpo sike	year	phrase
tenpo sin	again	phrase
tenpo suli	long time	phrase
tenpo suno	day	phrase
tenpo suno kama	tomorrow	phrase
tenpo suno kama la mi pali e lipu sin.	I'll update my web page next day.	phrase
tenpo suno mute li pini la mi tawa tomo.	A lot of days ago I went home.  ?	phrase
tenpo suno ni	today	phrase
tenpo suno pi nanpa luka	Friday	phrase
tenpo suno pi nanpa luka tu	Sunday	phrase
tenpo suno pi nanpa luka wan	Saturday	phrase
tenpo suno pi nanpa tu	Tuesday	phrase
tenpo suno pi nanpa tu tu	Thursday	phrase
tenpo suno pi nanpa tu wan	Wednesday	phrase
tenpo suno pi nanpa wan	Monday	phrase
tenpo suno pi pali ala	(public) holiday	phrase
tenpo suno pini	yesterday	phrase
tenpo suno pini la wan pi ilo HTML li pona lili. tenpo suno pini la wan pi ilo HTML li pona mute.	The HTML part is better now.	phrase
tenpo suno sin	morning	phrase
tenpo suno sin ale la sina moku e telo seli pimeja	Every morning I drink coffee.	phrase
tenpo telo	rainy season	phrase
toki Alapi	Arabic	phrase
toki Apikan	Afrikaans	phrase
toki Awasa	Hausa	phrase
toki Ewantalu	Ewantal	phrase
toki Inli pona	Basic English	phrase
toki Insi	Hindi	phrase
toki Intelinka	Interlingua	phrase
toki Inu	Inupiaq, Inuktitut, Eskimo	phrase
toki Ipo	Igbo	phrase
toki Ito	Ido	phrase
toki Iwisi	Hebrew	phrase
toki Jolupa	Yoruba	phrase
toki Kalike	Scots Gaelic	phrase
toki Kantun	Cantonese	phrase
toki Kisawili	Swahili	phrase
toki Kuwenja	Quenya, Elvish	phrase
toki Lolan	Loglan	phrase
toki Loma	Latin	phrase
toki Losupan	Lojban	phrase
toki Lunasimi	Quechua	phrase
toki Malasi	Marathi	phrase
toki Nosiki sin	Norwegian Nynorsk	phrase
toki Olapu	Volapьk	phrase
toki Pansapi	Punjabi	phrase
toki Pasiki	Fyksian	phrase
toki Pasuto	Pashto	phrase
toki Sami	Laplander	phrase
toki Sankitu	Sanskrit	phrase
toki Sinan	Klingon	phrase
toki Tamasiko	Berber, Tamazight	phrase
toki Tami	Tamil	phrase
toki Teluku	Telugu	phrase
toki Utu	Urdu	phrase
toki ike	to say negative things	phrase
toki ike lon	to say bad things about, complain about	phrase
toki ike tawa	to say bad things to, insult, speak rudely to	phrase
toki li pona tawa mi.	I like talking. / I like languages.	phrase
toki li pona.	Communication is good.	phrase
toki lon toki	to speak in a language	phrase
toki nanpa wan	primary language	phrase
toki pona e toki	to speak a language well	phrase
toki pona li toki pona.	Toki Pona is a good language.	phrase
toki pona lon	to say good things about, praise	phrase
toki pona tawa	to say nice things to, compliment	phrase
toki sitelen	written language	phrase
toki sona	proverbs	phrase
toki utala tawa	to argue with, criticize	phrase
tomo mi	my house	phrase
tomo pi jan Keli en mije ona li suli.	The house of Keli and her boyfriend is big.	phrase
tomo pi jan Lisa	Lisa's house	phrase
tomo pi ona mute	their house	phrase
tomo pi telo nasa	building of alcohol; a bar, pub, etc.	phrase
tomo tawa	car (moving construction)	phrase
tomo tawa kon	airplane, helicopter	phrase
tomo tawa telo	boat, ship	phrase
tomo lape	bedroom	phrase
tomo mani	bank	phrase
tomo mi li weka tan ni.	My house is away from here.	phrase
tomo moku	grocery store, restaurant	phrase
tomo pali	work(place), office, factory, etc.	phrase
tomo pi ijo kama jo	shop  ??	phrase
tomo pi telo en moku pana.	restaurant	phrase
tomo sona	school, university	phrase
tomo tawa sina li pakala ala pakala?	Is your car messed up?	phrase
tomo telo	restroom	phrase
tomo toki	chat room, conference room	phrase
tomo unpa	sex place, e.g. bedroom, boudoir, brothel, etc.	phrase
tu tu	2 + 2 = 4	phrase
tu wan	2 + 1 = 3	phrase
unpa li pona	sex is good, I like sex	phrase
unpa nasa	kinky sex	phrase
unpa sama soweli	doggy style	phrase
unpa uta	oral sex	phrase
utala li ike tawa mi.	I don't like wars.	phrase
utala li ike.	Conflict is bad.	phrase
walo pimeja	grey (dark white)	phrase
walo uta	teeth	phrase
wan sijelo	body part	phrase
waso li ken ala lukin la ona li kin ken jo e kili.	A blind chicken can find a corn too.	phrase
wawa li lon insa.	Energy comes from inside. Youth is all in the heart.	phrase
weka e ike jan	forgive somebody	phrase
weka lili li pona tawa lawa.	Temporary isolation is good for meditation.	phrase
wile e pona tawa jan	to wish somebody well	phrase
wile ike	to have negative intentions, malevolent	phrase
wile lape	to be tired, sleepy, wanting to rest	phrase
wile lawa	to be dominant	phrase
wile moku	to be hungry	phrase
wile moku e telo	thirsty	phrase
wile moli	suicidal	phrase
wile moli e jan	homicidal, wanting to murder	phrase
wile mute	to crave, really want	phrase
wile mute ike	to want too much, greedy	phrase
wile pali e ijo	bored, wanting to do something	phrase
wile pana e pona (tawa jan)	helpful (to someone)	phrase
wile pi jan ike li pakala e ijo.	The desires of evil people mess things up.	phrase
wile pona	to have good intentions, mean well	phrase
wile sona li mute e sona.	Curiosity feeds wisdom. One learns by asking questions.	phrase
wile unpa	horny, lustful	phrase
wile unpa e meli	to be sexually attracted to women	phrase
wile unpa e meli e mije	to be sexually attracted to women and men	phrase
wile unpa e mije	to be sexually attracted to men	phrase